MAP 1
MOVES 8
SCORE 6000
GOAL_BLOCK 0 12
GOAL_BISCUIT 0
GOAL_DOWN 0
GOAL_OBSTACLE 0
GOAL_CREAM 0
1 1 1 1 1 1 1 1
1 0 0 0 0 0 12 1
0 0 0 0 0 0 10 11
0 0 0 0 0 0 25 10
0 0 0 0 0 0 10 11
1 0 0 0 0 0 11 1
1 1 1 1 1 1 1 1
1 1 1 1 1 1 1 1
