MAP 8
MOVES 17
SCORE 10000
GOAL_BLOCK 
GOAL_BISCUIT 0
GOAL_DOWN 0
GOAL_OBSTACLE 12
GOAL_CREAM 0
0 0 0 1 1 0 0 0
0 0 0 6 6 0 0 0
0 0 0 6 6 0 0 0
1 0 0 6 6 0 0 1
1 0 0 6 6 0 0 1
0 0 0 6 6 0 0 0
0 0 0 6 6 0 0 0
0 0 0 1 1 0 0 0
