MAP 14
MOVES 22
SCORE 22000
GOAL_BLOCK 2 25 / 3 25
GOAL_BISCUIT 0
GOAL_DOWN 4
GOAL_OBSTACLE 16
GOAL_CREAM 0
5 1 5 1 1 5 1 5
6 6 6 6 6 6 6 6
0 0 0 0 0 0 0 0
0 0 0 0 0 0 0 0
0 0 0 0 0 0 0 0
6 6 6 6 6 6 6 6
0 0 0 0 0 0 0 0
0 0 0 0 0 0 0 0 