MAP 46
MOVES 28
SCORE 22000
GOAL_BLOCK 
GOAL_BISCUIT 26
GOAL_DOWN 0
GOAL_OBSTACLE 0
GOAL_CREAM 4
0 0 0 1 1 0 0 0
0 0 0 0 0 0 0 0
0 0 0 0 0 0 0 0
1 3 3 8 8 3 3 1
1 3 3 8 8 3 3 1
1 3 3 3 3 3 3 1
1 3 3 3 3 3 3 1
1 3 3 3 3 3 3 1
