MAP 21
MOVES 29
SCORE 22000
GOAL_BLOCK 
GOAL_BISCUIT 26
GOAL_DOWN 0
GOAL_OBSTACLE 0
GOAL_CREAM 0
1 1 0 0 0 0 1 1
1 0 0 0 0 0 0 1
0 0 0 0 0 0 0 0
0 0 0 0 0 0 0 0
2 2 2 2 2 2 2 2
2 2 2 2 2 2 2 2
1 4 4 4 4 4 4 1
1 1 4 4 4 4 1 1
