MAP 24
MOVES 25
SCORE 22000
GOAL_BLOCK 
GOAL_BISCUIT 32
GOAL_DOWN 0
GOAL_OBSTACLE 0
GOAL_CREAM 0
0 0 0 0 0 0 0 0
0 0 0 0 0 0 0 0
0 1 0 1 1 0 1 0
2 3 2 3 3 2 3 2
2 3 2 3 3 2 3 2
0 1 0 1 1 0 1 0
2 4 2 4 4 2 4 2
2 4 2 4 4 2 4 2 