MAP 31
MOVES 21
SCORE 22000
GOAL_BLOCK 
GOAL_BISCUIT 12
GOAL_DOWN 0
GOAL_OBSTACLE 11
GOAL_CREAM 0
0 0 1 1 1 1 1 1
0 0 0 0 1 1 1 1
0 0 0 0 0 0 1 1
0 0 0 0 0 0 0 0
6 6 6 0 0 0 0 0
4 4 6 6 6 0 0 0
4 4 4 4 6 6 6 0
4 4 4 4 4 4 6 6
