MAP 28
MOVES 20
SCORE 22000
GOAL_BLOCK 
GOAL_BISCUIT 16
GOAL_DOWN 0
GOAL_OBSTACLE 24
GOAL_CREAM 0
1 1 0 0 0 0 1 1
0 0 0 0 0 0 0 0
6 6 6 6 6 6 6 6
3 3 6 2 2 6 3 3
3 3 6 2 2 6 3 3
6 6 6 6 6 6 6 6
0 0 6 4 4 6 0 0
1 1 6 4 4 6 1 1
