MAP 47
MOVES 24
SCORE 23000
GOAL_BLOCK 6 20 / 7 20
GOAL_BISCUIT 12
GOAL_DOWN 0
GOAL_OBSTACLE 0
GOAL_CREAM 0
0 0 0 0 0 0 0 0
0 0 0 0 0 0 0 0
0 1 0 1 0 1 0 0
0 4 0 4 0 4 0 0
0 4 4 4 4 4 4 0
0 0 4 0 4 0 4 0
0 0 1 0 1 0 1 0
0 0 0 0 0 0 0 0
