MAP 9
MOVES 14
SCORE 10000
GOAL_BLOCK 
GOAL_BISCUIT 0
GOAL_DOWN 2
GOAL_OBSTACLE 0
GOAL_CREAM 0
1 1 0 0 0 5 1 1
1 0 5 0 0 0 0 1
0 0 12 0 0 0 0 0
0 0 10 0 0 0 0 0
0 0 12 10 0 0 0 0
0 0 10 0 0 0 0 0
0 0 12 0 0 0 0 0
0 0 12 0 0 0 0 0
