MAP 48
MOVES 22
SCORE 23000
GOAL_BLOCK 5 20 / 7 20
GOAL_BISCUIT 34
GOAL_DOWN 0
GOAL_OBSTACLE 0
GOAL_CREAM 0
3 3 3 3 0 21 20 0
3 1 1 3 0 0 0 0
3 4 1 3 0 0 0 0
3 4 4 4 4 3 3 3
3 3 3 4 4 4 4 3
0 0 0 0 3 1 4 3
0 0 0 0 3 1 1 3
0 20 21 0 3 3 3 3
