MAP 49
MOVES 22
SCORE 23000
GOAL_BLOCK 6 24 / 7 24
GOAL_BISCUIT 16
GOAL_DOWN 0
GOAL_OBSTACLE 0
GOAL_CREAM 0
0 0 0 0 0 0 0 0
0 0 0 0 0 0 0 0
0 4 4 1 1 4 4 0
0 1 4 4 4 4 1 0
0 1 4 4 4 4 1 0
0 4 4 1 1 4 4 0
0 0 0 0 0 0 0 0
0 0 0 0 0 0 0 0
