MAP 50
MOVES 20
SCORE 23000
GOAL_BLOCK 3 20 / 4 20
GOAL_BISCUIT 0
GOAL_DOWN 2
GOAL_OBSTACLE 0
GOAL_CREAM 4
0 0 0 5 5 0 0 0
0 0 0 0 0 0 0 0
0 0 1 0 0 1 0 0
0 0 1 0 0 1 0 0
0 0 1 0 0 1 0 0
0 0 1 0 0 1 0 0
0 0 8 8 8 8 0 0
0 0 0 0 0 0 0 0
