MAP 51
MOVES 19
SCORE 23000
GOAL_BLOCK 6 25 / 7 25
GOAL_BISCUIT 0
GOAL_DOWN 0
GOAL_OBSTACLE 12
GOAL_CREAM 0
0 0 0 0 0 0 0 0
0 0 6 6 6 6 0 0
0 0 1 6 6 1 0 0
0 0 1 1 1 1 0 0
0 0 1 1 1 1 0 0
0 0 1 6 6 1 0 0
0 0 6 6 6 6 0 0
0 0 0 0 0 0 0 0
