MAP 40
MOVES 19
SCORE 23000
GOAL_BLOCK 2 30 / 7 30
GOAL_BISCUIT 0
GOAL_DOWN 0
GOAL_OBSTACLE 16
GOAL_CREAM 0
1 0 0 0 0 0 0 0
0 0 0 0 0 0 0 0
0 0 0 0 6 6 1 1
6 6 6 6 6 6 1 1
1 1 6 6 6 6 6 6
1 1 6 6 0 0 0 0
0 0 0 0 0 0 0 0
0 0 0 0 0 0 0 1
