MAP 52
MOVES 18
SCORE 23000
GOAL_BLOCK 
GOAL_BISCUIT 0
GOAL_DOWN 2
GOAL_OBSTACLE 0
GOAL_CREAM 7
5 5 0 0 0 0 0 0
0 0 0 0 0 0 0 0
0 0 0 0 0 0 0 0
0 0 0 0 0 0 0 0
8 8 8 8 0 0 0 0
1 1 1 8 0 0 0 0
0 0 1 8 0 0 0 0
0 0 1 8 0 0 0 0
