jhMAP 53
MOVES 17
SCORE 23000
GOAL_BLOCK 5 20 / 6 20
GOAL_BISCUIT 0
GOAL_DOWN 0
GOAL_OBSTACLE 4
GOAL_CREAM 6
0 0 0 0 0 0 0 0
0 0 0 0 0 1 0 0
0 0 8 8 1 1 1 0
0 0 8 6 6 1 0 0
0 0 1 6 6 8 0 0
0 1 1 1 8 8 0 0
0 0 1 0 0 0 0 0
0 0 0 0 0 0 0 0 