aMAP 54
MOVES 18
SCORE 23000
GOAL_BLOCK 2 25 / 3 25
GOAL_BISCUIT 16
GOAL_DOWN 0
GOAL_OBSTACLE 0
GOAL_CREAM 0
0 0 0 0 1 0 0 0
0 0 0 0 1 1 0 0
0 0 0 0 0 1 1 0
0 0 0 0 0 0 1 1
1 1 0 0 4 4 4 4
0 1 1 0 4 4 4 4
0 0 1 1 4 4 4 4
0 0 0 1 4 4 4 4
