dfMAP 55
MOVES 24
SCORE 23000
GOAL_BLOCK 5 30 / 6 30 / 7 30
GOAL_BISCUIT 0
GOAL_DOWN 0
GOAL_OBSTACLE 0
GOAL_CREAM 0
0 0 0 0 0 0 0 0
0 0 0 0 0 0 0 0
0 0 0 1 1 0 0 0
0 0 1 1 1 1 0 0
0 0 1 1 1 1 0 0
0 0 0 1 1 0 0 0
0 0 0 0 0 0 0 0
0 0 0 0 0 0 0 0 