MAP 13
MOVES 22
SCORE 23000
GOAL_BLOCK 
GOAL_BISCUIT 16
GOAL_DOWN 0
GOAL_OBSTACLE 0
GOAL_CREAM 8
1 0 0 0 0 0 0 1
0 0 0 0 0 0 0 0
0 0 4 4 4 4 0 0
0 0 4 4 4 4 0 0
0 0 8 8 8 8 0 0
0 0 8 8 8 8 0 0
0 0 4 4 4 4 0 0
1 0 4 4 4 4 0 1
