MAP 19
MOVES 22
SCORE 23000
GOAL_BLOCK 2 25 / 3 25 / 4 25
GOAL_BISCUIT 0
GOAL_DOWN 0
GOAL_OBSTACLE 20
GOAL_CREAM 0
13 13 12 15 17 12 13 15
6 6 14 17 14 17 6 6
1 6 6 6 6 6 6 1
7 7 7 7 7 7 7 7
6 6 7 7 7 7 6 6
1 6 6 6 6 6 6 1
7 7 7 7 7 7 7 7
7 7 7 7 7 7 7 7
