MAP 20
MOVES 21
SCORE 23000
GOAL_BLOCK 
GOAL_BISCUIT 10
GOAL_DOWN 0
GOAL_OBSTACLE 20
GOAL_CREAM 0
1 1 1 12 17 1 1 1
1 1 17 13 12 15 1 1
1 6 13 14 13 15 6 1
6 6 6 6 6 6 6 6
6 6 6 6 6 6 6 6
1 6 4 4 4 4 6 1
1 1 4 4 4 4 1 1
1 1 1 4 4 1 1 1
