MAP 25
MOVES 32
SCORE 23000
GOAL_BLOCK 
GOAL_BISCUIT 16
GOAL_DOWN 0
GOAL_OBSTACLE 14
GOAL_CREAM 0
1 1 1 0 0 1 1 1
0 1 0 0 0 0 1 0
0 0 0 0 0 0 0 0
0 0 0 0 0 0 0 0
6 6 6 6 6 6 6 6
4 4 4 6 6 4 4 4
4 4 4 6 6 4 4 4
1 4 4 6 6 4 4 1
