MAP 0
MOVES 24
SCORE 23000
GOAL_BLOCK 5 32 / 7 32
GOAL_BISCUIT 0
GOAL_DOWN 0
GOAL_OBSTACLE 26
GOAL_CREAM 0
6 6 15 17 15 17 6 6
6 6 15 15 17 17 6 6
6 6 6 6 6 6 6 6
7 7 7 6 6 7 7 7
7 7 7 6 6 7 7 7
7 7 7 6 6 7 7 7
7 7 7 6 6 7 7 7
7 7 7 6 6 7 7 7
