MAP 56
MOVES 20
SCORE 23000
GOAL_BLOCK 
GOAL_BISCUIT 20
GOAL_DOWN 0
GOAL_OBSTACLE 12
GOAL_CREAM 0
0 0 0 1 1 0 0 0
0 0 0 1 1 0 0 0
0 4 0 1 1 0 4 0
4 4 4 1 1 4 4 4
4 4 4 1 1 4 4 4
6 4 4 1 1 4 4 6
6 6 4 1 1 4 6 6
6 6 6 1 1 6 6 6 