MAP 57
MOVES 21
SCORE 23000
GOAL_BLOCK 
GOAL_BISCUIT 0
GOAL_DOWN 4
GOAL_OBSTACLE 32
GOAL_CREAM 0
5 13 5 0 0 5 0 5
13 6 6 6 6 6 6 0
16 17 6 6 6 6 6 0
17 16 6 6 6 6 6 0
16 17 6 6 6 6 6 0
16 17 6 6 6 6 6 0
1 1 1 6 6 6 6 0
1 1 1 1 1 6 6 0
