MAP 58
MOVES 33
SCORE 23000
GOAL_BLOCK 
GOAL_BISCUIT 30
GOAL_DOWN 0
GOAL_OBSTACLE 16
GOAL_CREAM 0
0 0 0 0 0 0 0 0
6 2 2 2 2 2 2 6
6 2 2 2 2 2 2 6
6 3 3 3 3 3 3 6
6 3 3 3 3 3 6 1
6 4 4 4 4 6 1 1
6 4 4 4 6 1 1 1
6 6 6 6 1 1 1 1
