MAP 59
MOVES 31
SCORE 23000
GOAL_BLOCK 
GOAL_BISCUIT 18
GOAL_DOWN 0
GOAL_OBSTACLE 20
GOAL_CREAM 0
1 1 17 17 12 3 3 3
1 16 13 12 13 3 3 3
6 6 6 13 13 3 6 6
4 4 6 6 6 6 6 1
4 4 6 6 6 6 6 1
6 6 6 0 0 3 6 6
1 0 0 0 0 3 3 3
1 1 0 0 0 3 3 3
