MAP 27
MOVES 31
SCORE 23000
GOAL_BLOCK 6 30 / 7 30
GOAL_BISCUIT 0
GOAL_DOWN 0
GOAL_OBSTACLE 20
GOAL_CREAM 0
1 1 1 16 17 1 1 1
1 1 6 17 16 6 1 1
1 7 6 16 17 6 7 1
6 7 6 6 6 6 7 6
7 6 7 6 6 7 6 7
6 7 6 7 7 6 7 6
1 1 7 6 6 7 1 1
1 1 7 7 7 7 1 1
