MAP 11
MOVES 18
SCORE 10000
GOAL_BLOCK 0 25 / 1 25
GOAL_BISCUIT 0
GOAL_DOWN 0
GOAL_OBSTACLE 6
GOAL_CREAM 0
1 0 0 1 1 0 0 1
0 0 0 0 0 0 0 0
0 0 0 0 0 0 0 0
0 0 0 6 6 0 0 0
0 0 0 6 6 0 0 0
0 0 0 6 6 0 0 0
0 0 0 0 0 0 0 0
0 1 1 0 0 1 1 0
