MAP 60
MOVES 19
SCORE 23000
GOAL_BLOCK 6 30 / 7 30
GOAL_BISCUIT 22
GOAL_DOWN 0
GOAL_OBSTACLE 20
GOAL_CREAM 0
1 1 4 6 17 15 13 14
1 6 4 6 17 15 14 13
3 6 4 6 15 17 15 15
3 6 4 6 17 15 17 17
3 6 4 6 6 6 6 6
3 6 4 4 4 4 4 4
3 6 6 6 6 6 6 1
3 3 3 3 3 3 1 1
