MAP 61
MOVES 22
SCORE 23000
GOAL_BLOCK 
GOAL_BISCUIT 24
GOAL_DOWN 0
GOAL_OBSTACLE 12
GOAL_CREAM 0
0 0 0 0 0 0 0 0
0 0 3 0 0 3 0 0
0 3 6 3 3 6 3 0
3 6 4 6 6 4 6 3
3 6 4 4 4 4 6 3
0 3 6 4 4 6 3 0
1 0 3 6 6 3 0 1
1 1 0 3 3 0 1 1
