MAP 62
MOVES 20
SCORE 23000
GOAL_BLOCK 
GOAL_BISCUIT 0
GOAL_DOWN 2
GOAL_OBSTACLE 20
GOAL_CREAM 6
1 5 12 14 16 13 5 1
1 15 13 15 13 12 15 1
1 14 17 13 14 16 14 1
6 37 14 6 6 13 36 6
6 37 37 6 6 36 36 6
6 12 12 6 6 13 15 6
1 6 13 6 6 15 6 1
1 1 6 6 6 6 1 1
