MAP 13
MOVES 18
SCORE 23000
GOAL_BLOCK 
GOAL_BISCUIT 22
GOAL_DOWN 0
GOAL_OBSTACLE 0
GOAL_CREAM 24
1 0 0 0 0 0 0 1
0 8 8 0 0 8 8 0
8 21 21 8 8 21 21 8
8 4 4 8 8 4 4 8
8 4 4 8 8 4 4 8
8 4 4 8 8 4 4 8
3 8 8 3 3 8 8 3
1 3 3 3 3 3 3 1
