MAP 63
MOVES 18
SCORE 23000
GOAL_BLOCK 2 27 / 4 27
GOAL_BISCUIT 0
GOAL_DOWN 2
GOAL_OBSTACLE 10
GOAL_CREAM 0
0 5 0 1 1 0 5 0
0 0 0 1 1 0 0 0
0 0 1 1 1 1 0 0
1 1 1 6 6 1 1 1
6 6 6 6 6 6 6 6
0 0 0 0 0 0 0 0
0 0 0 0 0 0 0 0
0 0 0 0 0 0 0 0 