MAP 64
MOVES 24
SCORE 23000
GOAL_BLOCK 
GOAL_BISCUIT 36
GOAL_DOWN 0
GOAL_OBSTACLE 0
GOAL_CREAM 0
0 0 0 0 0 0 0 0
0 0 0 0 0 0 0 0
2 2 1 3 3 1 2 2
2 1 1 3 3 1 1 2
2 2 1 3 3 1 2 2
2 1 1 3 3 1 1 2
2 4 4 4 4 4 4 2
2 4 4 4 4 4 4 2 