MAP 65
MOVES 24
SCORE 23000
GOAL_BLOCK 6 24 / 7 24
GOAL_BISCUIT 0
GOAL_DOWN 2
GOAL_OBSTACLE 0
GOAL_CREAM 8
1 5 1 0 0 1 5 1
1 0 1 0 0 1 0 1
1 0 1 0 0 1 0 1
0 8 0 8 8 0 8 0
8 0 8 0 0 8 0 8
0 0 0 0 0 0 0 0
0 0 0 0 0 0 0 0
0 0 0 0 0 0 0 0
