MAP 10
MOVES 22
SCORE 23000
GOAL_BLOCK 
GOAL_BISCUIT 0
GOAL_DOWN 2
GOAL_OBSTACLE 0
GOAL_CREAM 18
1 5 0 1 1 0 5 1
0 0 0 1 1 0 0 0
0 0 16 1 1 17 0 0
36 36 0 8 8 0 37 37
8 7 8 7 7 8 7 8
7 8 7 8 8 7 8 7
8 7 8 7 7 8 7 8
7 7 7 7 7 7 7 7
