MAP 23
MOVES 21
SCORE 23000
GOAL_BLOCK 
GOAL_BISCUIT 0
GOAL_DOWN 0
GOAL_OBSTACLE 42
GOAL_CREAM 0
6 6 1 6 6 1 6 6
21 21 1 21 21 1 21 21
6 6 6 6 6 6 6 6
7 7 6 6 6 6 7 7
7 7 6 6 6 6 7 7
1 1 6 6 6 6 1 1
6 6 6 6 6 6 6 6
6 6 6 6 6 6 6 6
