MAP 24
MOVES 26
SCORE 23000
GOAL_BLOCK 
GOAL_BISCUIT 28
GOAL_DOWN 0
GOAL_OBSTACLE 0
GOAL_CREAM 8
0 0 0 0 0 0 0 0
0 0 0 0 0 0 0 0
0 1 0 1 1 0 1 0
8 3 8 3 3 8 3 8
3 8 3 8 8 3 8 3
3 1 3 1 1 3 1 3
3 3 4 4 4 4 3 3
3 3 4 4 4 4 3 3
