MAP 12
MOVES 16
SCORE 10000
GOAL_BLOCK 
GOAL_BISCUIT 0
GOAL_DOWN 4
GOAL_OBSTACLE 20
GOAL_CREAM 0
1 1 1 1 1 1 1 1
5 0 5 0 0 5 0 5
10 10 12 0 0 12 11 11
10 12 10 0 0 11 12 11
6 6 6 6 6 6 6 6
0 6 6 6 6 6 6 0
1 0 6 6 6 6 0 1
1 1 0 6 6 0 1 1
