MAP 25
MOVES 25
SCORE 23000
GOAL_BLOCK 
GOAL_BISCUIT 40
GOAL_DOWN 0
GOAL_OBSTACLE 0
GOAL_CREAM 0
1 1 1 0 0 1 1 1
0 1 0 0 0 0 1 0
0 2 3 0 0 3 2 0
2 3 4 3 3 4 3 2
3 4 21 4 4 21 4 3
2 3 4 3 3 4 3 2
3 2 3 2 2 3 2 3
1 3 2 4 4 2 3 1
