MAP 27
MOVES 31
SCORE 23000
GOAL_BLOCK 2 27 / 5 27
GOAL_BISCUIT 0
GOAL_DOWN 0
GOAL_OBSTACLE 23
GOAL_CREAM 0
1 1 1 15 12 1 1 1
1 1 6 12 15 6 1 1
1 6 6 15 12 6 7 1
6 7 6 6 6 6 6 7
7 6 7 6 7 6 7 6
6 7 6 7 6 7 6 7
1 1 7 6 7 6 1 1
1 1 6 7 6 7 1 1 