MAP 28
MOVES 21
SCORE 23000
GOAL_BLOCK 
GOAL_BISCUIT 0
GOAL_DOWN 0
GOAL_OBSTACLE 0
GOAL_CREAM 28
1 1 7 8 8 7 1 1
8 7 8 21 21 8 7 8
7 8 7 8 8 7 8 7
8 7 8 7 7 8 7 8
7 8 7 8 8 7 8 7
8 7 8 7 7 8 7 8
7 8 7 8 8 7 8 7
1 1 8 21 21 8 1 1
