MAP 29
MOVES 23
SCORE 23000
GOAL_BLOCK 2 24 / 3 24 / 4 24
GOAL_BISCUIT 40
GOAL_DOWN 0
GOAL_OBSTACLE 0
GOAL_CREAM 0
1 0 0 0 0 0 0 1
1 0 0 4 4 0 0 1
1 1 4 3 3 4 1 1
1 4 3 4 4 3 4 1
1 4 3 4 4 3 4 1
2 3 4 3 3 4 3 2
3 2 3 4 4 3 2 3
2 3 2 1 1 2 3 2 