MAP 30
MOVES 22
SCORE 23000
GOAL_BLOCK 5 27 / 6 27 / 7 27
GOAL_BISCUIT 0
GOAL_DOWN 0
GOAL_OBSTACLE 26
GOAL_CREAM 0
17 16 17 1 1 15 16 15
6 17 17 1 1 15 15 6
1 6 6 6 6 6 6 1
7 6 7 6 6 7 6 7
6 7 6 7 7 6 7 6
7 6 7 1 1 7 6 7
6 7 6 7 7 6 7 6
7 6 7 6 6 7 6 7
