MAP 32
MOVES 24
SCORE 23000
GOAL_BLOCK 
GOAL_BISCUIT 54
GOAL_DOWN 0
GOAL_OBSTACLE 0
GOAL_CREAM 0
2 3 4 2 3 4 1 1
3 4 2 3 4 2 1 1
4 2 3 4 2 3 4 1
2 3 4 2 3 4 2 3
3 4 2 3 4 2 3 4
1 2 3 4 2 3 4 2
1 1 4 2 3 4 2 3
1 1 2 3 4 2 3 4
