MAP 33
MOVES 20
SCORE 23000
GOAL_BLOCK 
GOAL_BISCUIT 0
GOAL_DOWN 0
GOAL_OBSTACLE 0
GOAL_CREAM 24
0 0 0 1 1 0 0 0
0 0 0 1 1 0 0 0
0 0 0 1 1 0 0 0
0 0 0 1 1 0 0 0
8 8 8 8 8 8 8 8
21 8 8 21 21 8 8 21
8 8 8 8 8 8 8 8
8 7 7 8 8 7 7 8
