MAP 34
MOVES 20
SCORE 23000
GOAL_BLOCK 6 24 / 7 24
GOAL_BISCUIT 30
GOAL_DOWN 0
GOAL_OBSTACLE 0
GOAL_CREAM 0
0 0 0 0 0 0 0 0
0 0 0 0 0 0 0 0
1 1 0 0 0 0 1 1
2 1 1 0 0 1 1 2
2 3 1 1 1 1 3 2
2 4 3 2 2 3 4 2
2 4 4 3 3 4 4 2
2 2 2 2 2 2 2 2 