MAP 36
MOVES 18
SCORE 23000
GOAL_BLOCK 5 20 / 6 20 / 7 20
GOAL_BISCUIT 0
GOAL_DOWN 0
GOAL_OBSTACLE 0
GOAL_CREAM 28
7 7 7 7 7 7 7 7
7 7 7 7 7 7 7 7
7 8 8 8 8 8 8 7
8 8 21 8 8 21 8 8
7 8 8 8 8 8 8 7
8 7 8 7 7 8 7 8
1 8 7 8 8 7 8 1
1 1 8 7 7 8 1 1
