MAP 37
MOVES 20
SCORE 23000
GOAL_BLOCK 5 27 / 6 27 / 7 27
GOAL_BISCUIT 0
GOAL_DOWN 0
GOAL_OBSTACLE 0
GOAL_CREAM 8
0 0 0 0 0 0 0 0
0 0 0 0 0 0 0 0
16 17 12 15 0 0 0 0
32 35 36 37 1 1 1 1
32 35 36 37 1 1 1 1
16 17 12 15 0 0 0 0
0 0 0 0 0 0 0 0
0 0 0 0 0 0 0 0 