MAP 13
MOVES 21
SCORE 10000
GOAL_BLOCK 0 25 / 1 25 / 2 25
GOAL_BISCUIT 0
GOAL_DOWN 0
GOAL_OBSTACLE 16
GOAL_CREAM 0
1 11 14 11 12 13 11 1
12 13 12 14 13 12 10 11
13 11 13 14 10 10 11 10
6 6 6 6 6 6 6 6
7 7 7 6 6 7 7 7
7 7 7 6 6 7 7 7
7 7 7 6 6 7 7 7
1 7 7 6 6 7 7 1
