MAP 38
MOVES 21
SCORE 23000
GOAL_BLOCK 5 24 / 6 24 / 7 24
GOAL_BISCUIT 0
GOAL_DOWN 0
GOAL_OBSTACLE 28
GOAL_CREAM 0
6 13 1 0 0 1 12 6
13 15 1 0 0 1 15 12
13 13 1 1 1 1 12 12
6 6 6 6 6 6 6 6
6 7 7 6 6 7 7 6
6 7 7 6 6 7 7 6
6 7 6 6 6 6 7 6
6 6 1 1 1 1 6 6
