MAP 40
MOVES 22
SCORE 23000
GOAL_BLOCK 
GOAL_BISCUIT 22
GOAL_DOWN 0
GOAL_OBSTACLE 0
GOAL_CREAM 18
1 0 0 0 2 2 2 2
0 0 0 0 2 8 8 8
2 2 2 2 2 8 1 1
8 8 8 8 2 8 1 1
1 1 8 2 8 8 8 8
1 1 8 2 2 2 2 2
8 8 8 2 0 0 0 0
2 2 2 2 0 0 0 1
