MAP 41
MOVES 29
SCORE 23000
GOAL_BLOCK 5 24 / 8 24
GOAL_BISCUIT 0
GOAL_DOWN 0
GOAL_OBSTACLE 0
GOAL_CREAM 15
0 0 0 0 0 1 7 7
0 0 0 0 0 1 7 7
0 0 0 0 0 1 1 1
0 0 21 8 8 7 7 7
0 0 8 8 7 8 8 8
0 0 8 7 8 7 7 7
1 1 8 7 8 7 7 8
1 1 8 7 8 7 8 7
