MAP 46
MOVES 26
SCORE 23000
GOAL_BLOCK 7 30 / 8 30
GOAL_BISCUIT 0
GOAL_DOWN 0
GOAL_OBSTACLE 30
GOAL_CREAM 0
7 6 6 1 1 6 6 7
7 6 18 6 6 17 6 7
6 18 15 6 6 15 17 6
1 6 18 6 6 17 6 1
1 6 6 6 6 6 6 1
1 7 7 6 6 7 7 1
1 6 6 7 7 6 6 1
1 7 7 6 6 7 7 1
