MAP 49
MOVES 21
SCORE 23000
GOAL_BLOCK 6 36 / 7 36
GOAL_BISCUIT 40
GOAL_DOWN 0
GOAL_OBSTACLE 14
GOAL_CREAM 0
6 6 6 6 6 6 6 6
6 6 6 22 22 6 6 6
4 4 4 1 1 4 4 4
4 1 4 4 4 4 1 4
4 1 4 4 4 4 1 4
4 4 4 1 1 4 4 4
4 4 4 4 4 4 4 4
4 4 4 4 4 4 4 4 