MAP 53
MOVES 20
SCORE 23000
GOAL_BLOCK 3 24 / 5 24 / 7 24
GOAL_BISCUIT 24
GOAL_DOWN 0
GOAL_OBSTACLE 0
GOAL_CREAM 0
0 0 0 0 0 0 0 0
0 2 2 2 2 1 0 0
0 2 3 3 1 1 1 0
0 2 3 4 4 1 2 0
0 2 1 4 4 3 2 0
0 1 1 1 3 3 2 0
0 0 1 2 2 2 2 0
0 0 0 0 0 0 0 0
