MAP 54
MOVES 26
SCORE 23000
GOAL_BLOCK 6 27 / 8 27
GOAL_BISCUIT 0
GOAL_DOWN 0
GOAL_OBSTACLE 32
GOAL_CREAM 0
6 6 6 6 1 6 20 19
6 7 7 6 1 1 6 6
6 7 7 7 6 1 1 6
6 6 7 6 7 6 1 1
1 1 6 7 6 7 6 6
6 1 1 6 7 7 7 6
6 6 1 1 6 7 7 6
19 20 6 1 6 6 6 6
