MAP 59
MOVES 24
SCORE 23000
GOAL_BLOCK 5 27 / 6 27
GOAL_BISCUIT 0
GOAL_DOWN 0
GOAL_OBSTACLE 14
GOAL_CREAM 14
1 1 7 7 7 7 7 7
1 6 6 6 6 6 6 6
20 0 0 0 0 0 0 0
6 6 6 6 6 6 6 1
8 7 8 7 8 7 8 1
7 8 7 8 7 8 7 8
1 7 8 7 8 7 8 7
1 1 7 8 7 8 7 8
