MAP 13
MOVES 18
SCORE 10000
GOAL_BLOCK 
GOAL_BISCUIT 8
GOAL_DOWN 0
GOAL_OBSTACLE 24
GOAL_CREAM 0
1 11 10 11 0 0 0 1
10 10 11 10 12 0 0 0
6 6 3 6 6 3 6 6
6 3 6 6 6 6 3 6
6 3 6 6 6 6 3 6
6 6 3 6 6 3 6 6
0 0 0 12 11 10 11 11
1 0 0 0 10 11 10 1
