MAP 4
MOVES 18
SCORE 23000
GOAL_BLOCK 
GOAL_BISCUIT 22
GOAL_DOWN 0
GOAL_OBSTACLE 12
GOAL_CREAM 0
1 1 0 0 0 0 1 1
1 1 0 0 0 0 1 1
18 6 4 4 4 4 6 14
18 6 4 6 6 4 6 14
4 4 6 4 4 6 4 4
18 6 4 6 6 4 6 14
1 1 4 4 4 4 1 1
1 1 4 4 4 4 1 1
