MAP 6
MOVES 20
SCORE 23000
GOAL_BLOCK 
GOAL_BISCUIT 50
GOAL_DOWN 0
GOAL_OBSTACLE 0
GOAL_CREAM 0
1 1 0 2 2 0 1 1
1 0 2 2 2 2 0 1
0 2 2 3 3 2 2 0
2 2 3 3 3 3 2 2
2 2 2 2 2 2 2 2
2 4 4 4 4 4 4 2
2 4 4 4 4 4 4 2
2 4 1 4 4 1 4 2 