MAP 8
MOVES 18
SCORE 23000
GOAL_BLOCK 3 24 / 6 24 / 8 24
GOAL_BISCUIT 0
GOAL_DOWN 0
GOAL_OBSTACLE 46
GOAL_CREAM 0
6 6 6 1 1 6 6 6
6 19 20 6 6 6 21 6
6 6 6 6 6 6 6 6
1 6 6 7 7 6 6 1
1 6 6 7 7 6 6 1
6 6 6 6 6 6 6 6
6 21 6 6 6 20 19 6
6 6 6 1 1 6 6 6
