MAP 11
MOVES 22
SCORE 23000
GOAL_BLOCK 8 32
GOAL_BISCUIT 0
GOAL_DOWN 2
GOAL_OBSTACLE 0
GOAL_CREAM 14
1 0 0 1 1 0 0 1
0 0 0 5 5 0 0 0
0 0 0 0 0 0 0 0
0 0 0 8 8 0 0 0
0 8 8 0 0 8 8 0
8 0 0 8 8 0 0 8
0 8 8 0 0 8 8 0
0 1 1 0 0 1 1 0
