MAP 18
MOVES 21
SCORE 23000
GOAL_BLOCK 6 35 / 8 35
GOAL_BISCUIT 0
GOAL_DOWN 0
GOAL_OBSTACLE 20
GOAL_CREAM 0
1 7 6 7 1 1 1 1
1 7 6 7 7 7 7 7
1 7 6 6 6 6 6 6
1 7 6 21 21 6 7 7
7 7 6 21 21 6 7 1
6 6 6 6 6 6 7 1
7 7 7 7 7 6 7 1
1 1 1 1 7 6 7 1
