MAP 13
MOVES 24
SCORE 23000
GOAL_BLOCK 
GOAL_BISCUIT 0
GOAL_DOWN 4
GOAL_OBSTACLE 16
GOAL_CREAM 10
1 0 5 0 0 5 0 1
5 0 0 0 0 0 0 5
0 0 0 0 0 0 0 0
6 8 0 0 0 0 8 6
0 6 8 0 0 8 6 0
6 0 6 8 8 6 0 6
8 6 0 6 6 0 6 8
1 8 6 6 6 6 8 1
