MAP 66
MOVES 20
SCORE 23000
GOAL_BLOCK 7 35
GOAL_BISCUIT 0
GOAL_DOWN 0
GOAL_OBSTACLE 16
GOAL_CREAM 8
6 17 6 1 1 6 17 6
17 14 17 1 1 17 14 17
6 6 6 6 6 6 6 6
7 7 6 7 7 6 7 7
7 6 7 8 8 7 6 7
1 7 8 7 7 8 7 1
1 8 7 7 7 7 8 1
1 7 7 8 8 7 7 1
