MAP 67
MOVES 15
SCORE 23000
GOAL_BLOCK 5 27 / 6 27
GOAL_BISCUIT 0
GOAL_DOWN 0
GOAL_OBSTACLE 28
GOAL_CREAM 4
1 0 0 6 6 0 0 1
6 6 0 6 6 0 6 6
6 6 0 0 0 0 6 6
1 6 16 8 8 0 6 1
1 6 16 8 8 0 6 1
6 6 0 16 0 0 6 6
6 6 0 6 6 0 6 6
1 0 0 6 6 0 0 1
