MAP 0
MOVES 25
SCORE 23000
GOAL_BLOCK 5 24 / 8 24
GOAL_BISCUIT 16
GOAL_DOWN 0
GOAL_OBSTACLE 16
GOAL_CREAM 0
0 0 0 0 0 15 0 0
0 0 0 0 15 0 15 0
6 4 6 4 6 4 6 4
4 6 4 6 4 6 4 6
6 4 6 4 6 4 6 4
4 6 4 6 4 6 4 6
0 0 0 0 0 0 0 0
0 0 0 0 0 0 0 0
