MAP 14
MOVES 19
SCORE 11000
GOAL_BLOCK 0 9
GOAL_BISCUIT 0
GOAL_DOWN 2
GOAL_OBSTACLE 10
GOAL_CREAM 0
0 1 5 1 1 5 1 0
0 0 0 0 0 0 0 0
0 0 0 0 0 0 0 0
0 0 6 0 0 6 0 0
0 0 6 0 0 6 0 0
0 0 6 0 0 6 0 0
0 0 6 0 0 6 0 0
0 0 6 0 0 6 0 0
