MAP 68
MOVES 16
SCORE 23000
GOAL_BLOCK 6 20 / 7 20 / 8 20
GOAL_BISCUIT 0
GOAL_DOWN 0
GOAL_OBSTACLE 20
GOAL_CREAM 0
0 16 0 1 1 0 18 0
16 0 16 1 1 18 0 18
6 6 6 6 6 6 6 6
7 7 7 6 6 7 7 7
7 7 7 6 6 7 7 7
6 6 6 6 6 6 6 6
7 7 7 1 1 7 7 7
7 7 7 1 1 7 7 7
