MAP 69
MOVES 22
SCORE 23000
GOAL_BLOCK 
GOAL_BISCUIT 20
GOAL_DOWN 0
GOAL_OBSTACLE 16
GOAL_CREAM 0
6 6 0 0 0 0 0 0
6 1 6 2 2 2 2 0
0 6 1 6 2 2 2 15
0 4 6 1 6 2 2 0
0 4 4 6 1 6 2 15
0 4 4 4 6 1 6 15
0 4 4 4 4 6 1 6
0 0 14 14 0 14 6 6
