MAP 70
MOVES 21
SCORE 23000
GOAL_BLOCK 7 24 / 8 24
GOAL_BISCUIT 0
GOAL_DOWN 0
GOAL_OBSTACLE 16
GOAL_CREAM 6
1 0 0 1 1 0 0 1
0 0 0 0 0 0 0 0
0 0 0 0 0 0 0 0
6 18 0 18 17 0 17 6
8 6 18 6 6 17 6 8
6 8 6 0 0 6 8 6
8 6 0 6 6 0 6 8
0 6 0 0 0 0 6 0
