MAP 71
MOVES 20
SCORE 23000
GOAL_BLOCK 
GOAL_BISCUIT 22
GOAL_DOWN 0
GOAL_OBSTACLE 12
GOAL_CREAM 0
1 0 0 1 1 0 0 1
0 0 0 0 0 0 0 0
0 3 3 4 4 3 3 0
1 3 3 4 4 3 3 1
1 1 3 4 4 3 1 1
1 3 6 6 6 6 3 1
1 3 6 6 6 6 3 1
1 3 6 6 6 6 3 1
