MAP 61
MOVES 18
SCORE 23000
GOAL_BLOCK 
GOAL_BISCUIT 16
GOAL_DOWN 0
GOAL_OBSTACLE 0
GOAL_CREAM 12
0 0 8 0 0 8 0 0
0 0 8 0 0 8 0 0
0 8 0 0 0 0 8 0
0 8 0 0 0 0 8 0
8 0 0 0 0 0 0 8
8 4 4 4 4 4 4 8
1 4 4 4 4 4 4 1
1 1 4 4 4 4 1 1 