MAP 60
MOVES 18
SCORE 23000
GOAL_BLOCK 
GOAL_BISCUIT 28
GOAL_DOWN 0
GOAL_OBSTACLE 0
GOAL_CREAM 10
1 1 0 8 0 0 0 0
1 0 8 3 3 3 3 0
0 8 8 4 4 4 3 0
8 3 4 4 4 4 3 0
0 3 4 4 4 4 3 8
0 3 4 4 4 8 8 0
0 3 3 3 3 8 0 1
0 0 0 0 8 0 1 1
