MAP 62
MOVES 27
SCORE 23000
GOAL_BLOCK 
GOAL_BISCUIT 20
GOAL_DOWN 0
GOAL_OBSTACLE 0
GOAL_CREAM 16
1 0 0 0 0 0 0 1
1 0 0 0 0 0 0 1
1 8 4 4 4 4 8 1
8 4 8 4 4 8 4 8
8 4 8 4 4 8 4 8
8 4 8 4 4 8 4 8
1 8 4 4 4 4 8 1
1 1 0 0 0 0 1 1
