MAP 72
MOVES 23
SCORE 23000
GOAL_BLOCK 
GOAL_BISCUIT 48
GOAL_DOWN 0
GOAL_OBSTACLE 0
GOAL_CREAM 8
1 2 2 2 2 2 2 1
2 2 8 4 4 8 2 2
2 8 1 4 4 1 8 2
2 4 4 4 4 4 4 2
2 4 4 4 4 4 4 2
2 8 1 4 4 1 8 2
2 2 8 4 4 8 2 2
1 2 2 2 2 2 2 1
