MAP 7
MOVES 22
SCORE 23000
GOAL_BLOCK 
GOAL_BISCUIT 44
GOAL_DOWN 0
GOAL_OBSTACLE 0
GOAL_CREAM 0
1 1 1 1 1 1 1 1
1 3 3 3 3 3 3 1
3 4 4 4 4 4 4 3
3 4 4 4 4 4 4 3
3 4 4 4 4 4 4 3
3 4 4 4 4 4 4 3
1 3 3 3 3 3 3 1
1 1 1 1 1 1 1 1
