MAP 56
MOVES 20
SCORE 23000
GOAL_BLOCK 
GOAL_BISCUIT 14
GOAL_DOWN 0
GOAL_OBSTACLE 0
GOAL_CREAM 12
0 0 0 1 1 0 0 0
8 0 0 1 1 0 0 8
0 8 0 1 1 0 8 0
4 4 8 1 1 8 4 4
4 4 4 1 1 4 4 4
4 4 8 1 1 8 4 4
0 8 0 1 1 0 8 0
8 0 0 1 1 0 0 8
