MAP 8
MOVES 26
SCORE 12000
GOAL_BLOCK 1 25 / 2 25
GOAL_BISCUIT 0
GOAL_DOWN 0
GOAL_OBSTACLE 20
GOAL_CREAM 0
0 0 6 1 1 6 0 0
0 0 6 6 6 6 0 0
0 0 0 6 6 11 10 0
1 11 10 6 6 10 11 1
1 10 11 6 6 11 10 1
0 11 10 6 6 0 0 0
0 0 6 6 6 6 0 0
0 0 6 1 1 6 0 0
