MAP 73
MOVES 26
SCORE 23000
GOAL_BLOCK 6 30 / 7 30 / 8 30
GOAL_BISCUIT 42
GOAL_DOWN 0
GOAL_OBSTACLE 0
GOAL_CREAM 0
1 1 0 0 0 0 1 1
1 1 0 0 0 0 1 1
1 3 3 3 3 3 3 1
3 3 4 4 4 4 3 3
3 3 4 4 4 4 3 3
3 3 4 4 4 4 3 3
3 3 4 4 4 4 3 3
1 1 3 3 3 3 1 1
