MAP 74
MOVES 20
SCORE 23000
GOAL_BLOCK 7 27 / 8 27
GOAL_BISCUIT 0
GOAL_DOWN 0
GOAL_OBSTACLE 12
GOAL_CREAM 14
1 1 1 0 0 1 1 1
1 0 0 0 0 0 0 1
0 0 0 17 18 0 0 0
8 8 37 0 0 38 8 8
8 34 37 37 38 38 8 8
6 6 18 6 6 17 6 6
1 6 6 0 0 6 6 1
1 1 0 6 6 0 1 1
