MAP 75
MOVES 22
SCORE 23000
GOAL_BLOCK 5 24 / 7 24
GOAL_BISCUIT 24
GOAL_DOWN 0
GOAL_OBSTACLE 16
GOAL_CREAM 0
1 1 0 0 0 0 1 1
0 0 0 4 4 0 0 0
0 0 4 4 4 4 0 0
0 4 4 4 4 4 4 0
4 4 4 6 6 4 4 4
4 4 6 6 6 6 4 4
4 6 6 21 21 6 6 4
1 6 6 6 6 6 6 1
