MAP 0
MOVES 24
SCORE 23000
GOAL_BLOCK 6 27 / 8 27
GOAL_BISCUIT 0
GOAL_DOWN 0
GOAL_OBSTACLE 8
GOAL_CREAM 16
0 0 0 0 0 0 0 0
8 8 8 0 0 0 0 0
8 22 8 0 0 0 0 0
8 8 8 0 0 0 0 0
6 6 6 6 6 6 6 6
7 7 7 7 7 8 8 8
7 7 7 7 7 8 22 8
7 7 7 7 7 8 8 8
