MAP 0
MOVES 22
SCORE 23000
GOAL_BLOCK 3 30 / 4 30
GOAL_BISCUIT 12
GOAL_DOWN 0
GOAL_OBSTACLE 27
GOAL_CREAM 0
0 0 0 0 0 0 0 0
6 6 6 6 13 6 6 6
7 6 6 13 14 6 6 7
7 6 6 6 13 6 6 7
7 6 6 6 13 6 6 7
7 4 4 6 6 4 4 7
7 4 6 4 4 6 4 7
7 4 6 4 4 6 4 7
