MAP 9
MOVES 21
SCORE 23000
GOAL_BLOCK 
GOAL_BISCUIT 30
GOAL_DOWN 0
GOAL_OBSTACLE 24
GOAL_CREAM 0
1 1 0 0 0 0 1 1
1 2 6 2 2 6 2 1
2 6 2 6 6 2 6 2
6 3 6 4 4 6 3 6
3 6 4 4 4 4 6 3
6 3 4 4 4 4 3 6
3 6 4 6 6 4 6 3
6 3 6 6 6 6 3 6
