MAP 0
MOVES 20
SCORE 23000
GOAL_BLOCK 
GOAL_BISCUIT 30
GOAL_DOWN 0
GOAL_OBSTACLE 8
GOAL_CREAM 8
0 0 0 0 0 8 4 8
6 0 0 0 0 4 4 4
2 6 2 2 2 8 4 8
2 2 6 4 4 6 2 2
2 2 6 4 4 6 2 2
8 4 8 2 2 2 6 2
4 4 4 0 0 0 0 6
8 4 8 0 0 0 0 0
