MAP 76
MOVES 22
SCORE 23000
GOAL_BLOCK 8 30
GOAL_BISCUIT 16
GOAL_DOWN 0
GOAL_OBSTACLE 22
GOAL_CREAM 0
0 0 1 1 1 1 0 0
0 0 18 1 1 18 0 0
0 0 15 18 18 13 0 0
6 6 6 6 6 6 6 6
6 4 4 4 4 4 4 6
6 4 6 6 6 6 4 6
6 4 6 4 4 6 4 6
1 4 6 4 4 6 4 1
