MAP 77
MOVES 18
SCORE 23000
GOAL_BLOCK 3 30 / 7 30
GOAL_BISCUIT 0
GOAL_DOWN 4
GOAL_OBSTACLE 28
GOAL_CREAM 0
1 6 5 0 0 5 6 1
5 6 6 0 0 6 6 5
6 6 6 13 0 6 6 6
7 6 6 13 17 6 6 7
7 7 6 17 13 6 7 7
7 7 6 0 17 6 7 7
7 7 6 0 0 6 7 7
6 6 6 0 0 6 6 6
