MAP 58
MOVES 20
SCORE 23000
GOAL_BLOCK 5 30 / 6 30
GOAL_BISCUIT 0
GOAL_DOWN 0
GOAL_OBSTACLE 14
GOAL_CREAM 7
0 0 0 0 0 0 0 0
6 6 6 6 6 6 0 0
8 6 16 16 15 6 0 0
7 8 6 15 17 6 0 0
7 7 8 6 15 6 0 1
7 7 7 8 6 6 1 1
8 7 7 7 8 1 1 1
7 8 7 7 1 1 1 1
