MAP 78
MOVES 20
SCORE 23000
GOAL_BLOCK 6 24 / 8 24
GOAL_BISCUIT 0
GOAL_DOWN 0
GOAL_OBSTACLE 28
GOAL_CREAM 0
6 0 0 0 0 0 0 6
6 6 18 14 15 16 6 6
6 6 6 18 16 6 6 6
1 1 1 18 16 1 1 1
7 6 1 6 6 1 6 7
7 6 7 6 6 7 6 7
7 7 7 6 6 7 7 7
7 6 6 6 6 6 6 7
