MAP 74
MOVES 20
SCORE 23000
GOAL_BLOCK 3 30 / 4 30
GOAL_BISCUIT 18
GOAL_DOWN 0
GOAL_OBSTACLE 0
GOAL_CREAM 12
1 1 1 0 0 1 1 1
1 0 0 0 0 0 0 1
0 0 0 8 8 0 0 0
0 8 8 4 4 8 8 0
0 4 4 4 4 4 4 0
0 4 8 4 4 8 4 0
1 8 4 8 8 4 8 1
1 1 4 4 4 4 1 1
