MAP 79
MOVES 20
SCORE 23000
GOAL_BLOCK 
GOAL_BISCUIT 10
GOAL_DOWN 2
GOAL_OBSTACLE 20
GOAL_CREAM 0
1 0 5 0 0 5 0 1
1 0 6 0 0 6 0 1
0 6 6 4 4 6 6 0
0 6 4 4 4 4 6 0
0 6 4 4 4 4 6 0
0 6 6 6 6 6 6 0
1 6 7 7 7 7 6 1
1 6 7 7 7 7 6 1
