MAP 80
MOVES 19
SCORE 23000
GOAL_BLOCK 6 27 / 7 27
GOAL_BISCUIT 0
GOAL_DOWN 0
GOAL_OBSTACLE 15
GOAL_CREAM 10
0 0 0 1 1 1 1 1
0 0 17 6 6 8 1 1
17 15 18 6 7 8 6 6
15 18 13 6 7 8 6 7
16 13 18 6 7 8 6 7
8 8 38 6 7 8 6 7
7 7 7 6 7 8 6 7
7 7 7 6 7 8 6 7
