MAP 81
MOVES 20
SCORE 23000
GOAL_BLOCK 
GOAL_BISCUIT 24
GOAL_DOWN 0
GOAL_OBSTACLE 0
GOAL_CREAM 10
0 0 1 0 0 1 0 0
0 0 1 0 0 1 0 0
2 3 3 3 3 3 3 2
2 3 4 4 4 4 3 2
2 3 4 4 4 4 3 2
1 8 8 8 8 8 8 1
1 8 7 7 7 7 8 1
1 8 7 7 7 7 8 1
