MAP 9
MOVES 21
SCORE 23000
GOAL_BLOCK 
GOAL_BISCUIT 24
GOAL_DOWN 0
GOAL_OBSTACLE 7
GOAL_CREAM 7
1 1 0 0 0 0 1 1
1 0 0 0 8 0 0 1
4 4 4 8 0 4 4 4
4 4 4 0 8 4 4 4
6 6 6 8 6 6 6 6
0 4 4 0 8 4 4 0
0 4 4 8 0 4 4 0
0 4 4 0 8 4 4 0 