MAP 82
MOVES 21
SCORE 23000
GOAL_BLOCK 3 27 / 6 27
GOAL_BISCUIT 22
GOAL_DOWN 0
GOAL_OBSTACLE 6
GOAL_CREAM 0
1 1 0 0 0 0 1 1
1 0 6 0 0 6 0 1
0 6 4 6 6 4 6 0
0 4 1 4 4 1 4 0
0 4 4 4 4 4 4 0
0 4 4 1 1 4 4 0
1 0 4 4 4 4 0 1
1 1 0 4 4 0 1 1
