MAP 83
MOVES 19
SCORE 23000
GOAL_BLOCK 7 24 / 8 24
GOAL_BISCUIT 42
GOAL_DOWN 0
GOAL_OBSTACLE 0
GOAL_CREAM 0
0 2 2 2 2 2 2 0
0 2 2 2 2 2 2 0
0 2 2 2 2 2 2 0
1 0 1 0 0 1 0 1
0 4 4 4 4 4 4 0
0 4 4 4 4 4 4 0
0 4 4 4 4 4 4 0
0 4 4 4 4 4 4 0
