MAP 84
MOVES 20
SCORE 23000
GOAL_BLOCK 7 30 / 8 30
GOAL_BISCUIT 0
GOAL_DOWN 0
GOAL_OBSTACLE 28
GOAL_CREAM 0
1 1 0 1 1 0 1 1
1 0 18 0 18 0 0 1
6 0 6 18 18 6 0 6
7 6 7 6 6 7 6 7
6 7 6 6 6 6 7 6
6 6 6 7 7 6 6 6
1 6 6 7 7 6 6 1
1 1 6 6 6 6 1 1
