MAP 85
MOVES 22
SCORE 23000
GOAL_BLOCK 6 24 / 7 24 / 8 24
GOAL_BISCUIT 46
GOAL_DOWN 0
GOAL_OBSTACLE 0
GOAL_CREAM 0
1 0 0 0 0 0 0 1
0 0 0 0 0 0 0 0
3 3 4 4 4 4 3 3
4 4 4 3 3 4 4 4
3 4 4 4 4 4 4 3
4 4 4 3 3 4 4 4
3 4 4 4 4 4 4 3
4 4 1 4 4 1 4 4 