MAP 2
MOVES 10
SCORE 8000
GOAL_BLOCK 0 12 / 1 12
GOAL_BISCUIT 0
GOAL_DOWN 0
GOAL_OBSTACLE 0
GOAL_CREAM 0
1 1 1 1 1 1 1 1
1 0 0 0 11 10 12 1
1 0 0 0 10 11 12 1
1 0 0 0 12 11 10 1
1 0 0 0 11 10 10 1
1 0 0 0 12 11 12 1
1 0 0 0 11 10 11 1
1 1 1 1 1 1 1 1
