MAP 0
MOVES 15
SCORE 12000
GOAL_BLOCK 2 20 / 4 20
GOAL_BISCUIT 16
GOAL_DOWN 0
GOAL_OBSTACLE 0
GOAL_CREAM 16
0 0 0 0 0 0 0 0
0 0 0 0 0 0 0 0
0 0 0 0 0 0 0 0
2 2 2 2 2 2 2 2
8 33 32 12 13 33 32 8
8 7 8 13 12 8 7 8
8 8 8 12 13 8 8 8
2 2 2 2 2 2 2 2
