MAP 67
MOVES 18
SCORE 23000
GOAL_BLOCK 
GOAL_BISCUIT 0
GOAL_DOWN 0
GOAL_OBSTACLE 0
GOAL_CREAM 24
1 14 17 36 0 0 0 1
8 15 16 17 8 0 0 8
8 38 36 36 8 8 8 8
1 7 7 7 7 7 7 1
1 7 7 7 7 7 7 1
8 8 8 8 8 8 8 8
8 7 7 8 7 7 7 8
1 7 7 7 8 7 7 1
