MAP 88
MOVES 20
SCORE 23000
GOAL_BLOCK 
GOAL_BISCUIT 35
GOAL_DOWN 0
GOAL_OBSTACLE 0
GOAL_CREAM 0
0 0 1 0 0 0 0 0
0 0 1 0 0 0 0 0
0 0 1 1 1 1 0 0
4 4 4 4 4 1 2 2
4 4 4 4 4 1 2 2
4 4 4 4 4 1 2 2
4 4 4 4 4 1 2 2
4 4 4 4 4 1 2 2
