MAP 89
MOVES 20
SCORE 23000
GOAL_BLOCK 
GOAL_BISCUIT 0
GOAL_DOWN 0
GOAL_OBSTACLE 8
GOAL_CREAM 12
0 0 0 0 0 6 1 1
0 0 0 0 8 6 8 1
0 0 0 8 7 6 7 8
0 0 0 0 8 6 8 7
0 0 0 0 8 6 8 7
0 0 0 8 7 6 7 8
0 0 0 0 8 6 8 1
0 0 0 0 0 6 1 1
