MAP 0
MOVES 20
SCORE 23000
GOAL_BLOCK 6 20 / 7 20
GOAL_BISCUIT 8
GOAL_DOWN 0
GOAL_OBSTACLE 16
GOAL_CREAM 0
0 0 0 0 6 0 6 0
0 0 0 0 0 6 0 6
0 0 0 0 6 0 6 0
0 0 0 0 0 6 0 6
0 0 0 0 6 4 6 4
0 0 0 0 4 6 4 6
0 0 0 0 6 4 6 4
0 0 0 0 4 6 4 6
