MAP 83
MOVES 16
SCORE 23000
GOAL_BLOCK 6 24 / 8 24
GOAL_BISCUIT 0
GOAL_DOWN 0
GOAL_OBSTACLE 4
GOAL_CREAM 8
0 0 0 0 0 0 0 0
0 0 0 0 0 0 0 0
6 0 6 0 0 6 0 6
1 8 1 8 8 1 8 1
8 7 8 7 7 8 7 8
7 7 7 7 7 7 7 7
7 7 7 7 7 7 7 7
7 7 7 7 7 7 7 7
