MAP 90
MOVES 16
SCORE 23000
GOAL_BLOCK 
GOAL_BISCUIT 14
GOAL_DOWN 4
GOAL_OBSTACLE 0
GOAL_CREAM 2
5 0 1 5 5 1 0 5
0 0 0 0 0 0 0 0
0 0 0 0 0 0 0 0
1 0 0 0 0 0 0 1
41 0 4 4 4 4 0 41
1 0 4 4 4 4 0 1
0 0 4 4 4 4 0 0
0 0 4 1 1 4 0 0
