MAP 0
MOVES 16
SCORE 23000
GOAL_BLOCK 4 24 / 7 24
GOAL_BISCUIT 16
GOAL_DOWN 0
GOAL_OBSTACLE 18
GOAL_CREAM 0
0 0 0 0 0 0 0 0
0 0 0 0 0 0 0 0
0 0 0 0 0 0 0 0
0 2 2 6 6 2 2 0
0 2 4 6 6 4 2 0
0 4 6 6 6 6 4 0
4 6 4 6 6 4 6 4
6 4 6 6 6 6 4 6
