MAP 91
MOVES 18
SCORE 23000
GOAL_BLOCK 5 40 / 6 40
GOAL_BISCUIT 28
GOAL_DOWN 0
GOAL_OBSTACLE 26
GOAL_CREAM 0
1 6 6 6 6 6 6 1
6 6 6 22 22 6 6 6
6 6 6 6 6 6 6 6
1 6 6 6 6 6 6 1
4 4 4 4 4 4 4 4
4 4 4 4 4 4 4 4
1 4 4 4 4 4 4 1
1 4 4 4 4 4 4 1
