MAP 8
MOVES 21
SCORE 12000
GOAL_BLOCK 0 20 / 1 20
GOAL_BISCUIT 18
GOAL_DOWN 0
GOAL_OBSTACLE 0
GOAL_CREAM 18
2 2 2 1 1 2 2 2
2 2 2 0 0 2 2 2
2 2 2 0 0 2 2 2
1 0 0 0 0 0 0 1
1 0 0 0 0 0 0 1
8 8 8 0 0 8 8 8
8 8 8 0 0 8 8 8
8 8 8 1 1 8 8 8
