MAP 92
MOVES 18
SCORE 23000
GOAL_BLOCK 6 20 / 8 20
GOAL_BISCUIT 18
GOAL_DOWN 0
GOAL_OBSTACLE 10
GOAL_CREAM 0
1 0 0 0 0 0 0 1
1 0 0 0 0 0 0 1
1 0 0 0 0 0 0 1
1 1 6 6 6 6 1 1
1 6 6 6 6 6 6 1
1 2 4 4 4 4 2 1
1 2 4 4 4 4 2 1
1 2 2 2 2 2 2 1
