MAP 93
MOVES 18
SCORE 23000
GOAL_BLOCK 6 20 / 7 20 / 8 20
GOAL_BISCUIT 0
GOAL_DOWN 0
GOAL_OBSTACLE 20
GOAL_CREAM 0
1 1 16 16 17 14 1 1
1 18 18 17 16 17 1 1
6 6 6 6 6 6 6 6
6 0 0 0 0 0 0 6
6 0 0 0 0 0 0 6
6 6 6 6 6 6 6 6
1 0 0 0 0 0 1 1
1 1 0 0 0 0 1 1
