MAP 23
MOVES 16
SCORE 23000
GOAL_BLOCK 5 20 / 6 20
GOAL_BISCUIT 12
GOAL_DOWN 0
GOAL_OBSTACLE 0
GOAL_CREAM 8
0 0 1 0 0 1 0 0
0 0 1 8 8 1 0 0
0 0 8 0 0 8 0 0
4 4 0 4 4 0 4 4
4 4 0 4 4 0 4 4
1 1 8 0 0 8 1 1
0 0 0 8 8 0 0 0
0 0 0 0 0 0 0 0
