MAP 24
MOVES 18
SCORE 23000
GOAL_BLOCK 7 24 / 8 24
GOAL_BISCUIT 12
GOAL_DOWN 0
GOAL_OBSTACLE 12
GOAL_CREAM 0
0 0 0 0 0 0 0 0
0 0 0 0 0 0 0 0
0 1 0 1 1 0 1 0
6 6 6 0 4 4 4 0
6 6 6 0 4 4 4 0
0 1 0 1 1 0 1 0
0 4 4 4 0 6 6 6
0 4 4 4 0 6 6 6 