MAP 25
MOVES 20
SCORE 23000
GOAL_BLOCK 3 24 / 4 24
GOAL_BISCUIT 0
GOAL_DOWN 4
GOAL_OBSTACLE 0
GOAL_CREAM 6
1 1 1 0 0 1 1 1
5 1 5 0 0 5 1 5
0 0 0 0 0 0 0 0
0 0 0 0 0 0 0 0
0 0 0 0 0 0 0 0
0 0 0 0 0 0 0 0
8 8 0 0 0 0 8 8
1 8 0 0 0 0 8 1 