MAP 26
MOVES 18
SCORE 23000
GOAL_BLOCK 4 20 / 5 20
GOAL_BISCUIT 0
GOAL_DOWN 0
GOAL_OBSTACLE 6
GOAL_CREAM 6
0 0 1 0 0 1 0 0
0 0 0 0 0 0 0 0
0 0 1 6 6 1 0 0
6 0 6 0 0 6 0 6
0 0 1 8 8 1 0 0
8 0 8 0 0 8 0 8
0 0 1 0 0 1 0 0
0 0 0 0 0 0 0 0
