MAP 27
MOVES 18
SCORE 23000
GOAL_BLOCK 
GOAL_BISCUIT 0
GOAL_DOWN 4
GOAL_OBSTACLE 6
GOAL_CREAM 0
1 1 1 5 5 1 1 1
1 1 0 0 0 0 1 1
1 5 0 0 0 0 5 1
0 0 0 6 6 0 0 0
0 0 6 0 0 6 0 0
0 6 0 0 0 0 6 0
1 1 0 0 0 0 1 1
1 1 0 0 0 0 1 1
