MAP 28
MOVES 18
SCORE 23000
GOAL_BLOCK 6 20 / 7 20
GOAL_BISCUIT 10
GOAL_DOWN 0
GOAL_OBSTACLE 0
GOAL_CREAM 8
1 1 0 0 0 0 1 1
0 8 0 8 0 0 0 0
0 0 4 0 8 0 8 0
0 4 4 4 0 4 0 0
0 0 4 0 4 4 4 0
0 8 0 8 0 4 0 0
0 0 0 0 8 0 8 0
1 1 0 0 0 0 1 1 