MAP 30
MOVES 16
SCORE 23000
GOAL_BLOCK 5 27 / 7 27
GOAL_BISCUIT 0
GOAL_DOWN 0
GOAL_OBSTACLE 0
GOAL_CREAM 6
0 0 0 1 1 0 0 0
0 0 0 1 1 0 0 0
1 0 0 0 0 0 0 1
0 8 0 8 8 0 8 0
0 0 0 0 0 0 0 0
0 8 0 1 1 0 8 0
0 0 0 0 0 0 0 0
0 0 0 0 0 0 0 0
