MAP 13
MOVES 16
SCORE 14000
GOAL_BLOCK 
GOAL_BISCUIT 0
GOAL_DOWN 0
GOAL_OBSTACLE 24
GOAL_CREAM 10
1 6 11 13 14 11 6 1
6 14 12 14 12 10 11 6
6 6 13 10 11 13 6 6
6 6 11 11 10 11 6 6
6 8 8 8 31 8 8 6
6 8 7 7 7 7 8 6
6 8 7 7 7 7 8 6
1 6 6 6 6 6 6 1
