MAP 33
MOVES 18
SCORE 23000
GOAL_BLOCK 
GOAL_BISCUIT 20
GOAL_DOWN 0
GOAL_OBSTACLE 18
GOAL_CREAM 0
0 0 0 1 1 0 0 0
0 0 0 1 1 0 0 0
0 0 0 1 1 0 0 0
3 3 6 1 1 6 3 3
6 6 3 6 6 3 6 6
3 3 6 3 3 6 3 3
6 6 3 6 6 3 6 6
3 3 6 3 3 6 3 3 