MAP 34
MOVES 18
SCORE 23000
GOAL_BLOCK 5 27 / 6 27
GOAL_BISCUIT 0
GOAL_DOWN 0
GOAL_OBSTACLE 6
GOAL_CREAM 0
0 0 0 14 0 0 0 0
0 0 0 0 14 14 0 0
1 1 6 6 6 6 1 1
7 1 1 7 7 1 1 7
7 6 1 1 1 1 6 7
7 7 7 7 7 7 7 7
7 7 7 7 7 7 7 7
7 7 7 7 7 7 7 7
