MAP 36
MOVES 16
SCORE 23000
GOAL_BLOCK 7 20 / 8 20
GOAL_BISCUIT 8
GOAL_DOWN 0
GOAL_OBSTACLE 0
GOAL_CREAM 8
0 0 0 0 0 0 0 0
0 0 0 0 0 0 0 0
0 0 0 0 0 0 0 0
0 0 0 2 2 0 0 0
0 0 2 2 2 2 0 0
8 0 8 2 2 8 0 8
1 0 0 8 8 0 0 1
1 1 8 0 0 8 1 1
