MAP 37
MOVES 18
SCORE 23000
GOAL_BLOCK 
GOAL_BISCUIT 24
GOAL_DOWN 0
GOAL_OBSTACLE 7
GOAL_CREAM 0
0 0 0 0 0 0 0 0
0 0 0 0 0 0 0 0
0 0 0 6 6 6 6 6
0 0 0 6 1 1 1 1
0 0 0 6 1 1 1 1
2 3 4 2 3 4 2 3
4 2 3 4 2 3 4 2
3 4 2 3 4 2 3 4 