MAP 38
MOVES 18
SCORE 23000
GOAL_BLOCK 
GOAL_BISCUIT 0
GOAL_DOWN 2
GOAL_OBSTACLE 18
GOAL_CREAM 0
0 0 1 5 5 1 0 0
0 0 1 0 0 1 0 0
0 0 1 1 1 1 0 0
0 6 6 6 6 6 6 0
0 6 0 6 6 0 6 0
0 0 6 0 0 6 0 0
0 6 6 6 6 6 6 0
0 0 1 1 1 1 0 0
