MAP 39
MOVES 20
SCORE 23000
GOAL_BLOCK 
GOAL_BISCUIT 42
GOAL_DOWN 0
GOAL_OBSTACLE 0
GOAL_CREAM 0
0 0 1 0 0 1 0 0
0 1 1 0 0 1 1 0
1 1 3 4 4 3 1 1
3 3 4 2 2 4 3 3
4 4 2 2 2 2 4 4
4 4 2 1 1 2 4 4
3 3 4 2 2 4 3 3
3 3 3 4 4 3 3 3 