MAP 40
MOVES 16
SCORE 23000
GOAL_BLOCK 3 27 / 4 27
GOAL_BISCUIT 0
GOAL_DOWN 0
GOAL_OBSTACLE 4
GOAL_CREAM 4
1 0 0 0 0 0 0 0
0 0 0 0 0 0 6 6
0 0 0 0 0 6 1 1
8 8 0 0 0 6 1 1
1 1 8 0 0 0 0 0
1 1 8 0 0 0 0 0
0 0 0 0 0 0 0 0
0 0 0 0 0 0 0 1
