MAP 41
MOVES 16
SCORE 23000
GOAL_BLOCK 7 30 / 8 30
GOAL_BISCUIT 0
GOAL_DOWN 2
GOAL_OBSTACLE 0
GOAL_CREAM 5
5 0 0 0 0 1 0 5
0 0 0 0 0 1 0 0
0 0 0 0 0 1 1 1
0 0 0 0 0 0 0 8
0 0 0 0 0 0 0 0
8 8 0 0 0 0 0 0
1 1 8 0 0 0 0 0
1 1 8 0 0 0 0 0
