MAP 6
MOVES 16
SCORE 13000
GOAL_BLOCK 1 25
GOAL_BISCUIT 0
GOAL_DOWN 2
GOAL_OBSTACLE 12
GOAL_CREAM 16
1 1 0 0 0 0 1 1
1 5 12 11 10 14 5 1
8 34 11 14 11 11 32 8
6 6 6 6 6 6 6 6
6 7 7 7 7 7 7 6
6 7 7 7 7 7 7 6
8 8 7 8 8 7 8 8
8 8 1 8 8 1 8 8
