MAP 42
MOVES 17
SCORE 23000
GOAL_BLOCK 
GOAL_BISCUIT 20
GOAL_DOWN 0
GOAL_OBSTACLE 10
GOAL_CREAM 0
0 0 0 0 0 0 0 0
0 0 0 0 0 1 1 0
6 6 6 6 6 4 4 0
0 1 1 1 0 4 4 0
0 1 1 1 0 4 4 0
6 6 6 6 6 4 4 0
4 4 4 4 4 1 1 0
4 4 4 4 4 4 4 0
