MAP 43
MOVES 18
SCORE 23000
GOAL_BLOCK 
GOAL_BISCUIT 48
GOAL_DOWN 0
GOAL_OBSTACLE 0
GOAL_CREAM 0
3 4 2 3 4 2 3 4
2 3 4 2 3 4 2 3
0 0 1 1 1 1 1 1
4 3 2 4 3 2 4 3
3 2 4 3 2 4 3 2
1 1 1 1 1 1 0 0
3 4 2 3 4 2 3 4
2 3 4 2 3 4 2 3 