MAP 44
MOVES 16
SCORE 23000
GOAL_BLOCK 5 21 / 6 21 / 7 21
GOAL_BISCUIT 0
GOAL_DOWN 0
GOAL_OBSTACLE 16
GOAL_CREAM 0
0 0 0 0 0 0 0 0
0 0 0 6 6 0 0 0
0 0 6 0 0 6 0 0
0 6 0 6 6 0 6 0
0 0 6 0 0 6 0 0
6 6 0 6 6 0 6 6
7 7 1 1 1 1 7 7
7 7 1 7 7 1 7 7
