MAP 45
MOVES 18
SCORE 23000
GOAL_BLOCK 5 24 / 6 24 / 7 24 / 8 24
GOAL_BISCUIT 0
GOAL_DOWN 0
GOAL_OBSTACLE 0
GOAL_CREAM 0
0 0 0 0 0 0 0 0
0 0 0 0 0 0 0 0
1 1 1 0 0 1 1 1
0 0 1 0 0 1 0 0
0 0 1 0 0 1 0 0
1 1 1 0 0 1 1 1
0 0 0 0 0 0 0 0
0 0 0 0 0 0 0 0 