MAP 46
MOVES 18
SCORE 23000
GOAL_BLOCK 3 21 / 4 21
GOAL_BISCUIT 26
GOAL_DOWN 0
GOAL_OBSTACLE 6
GOAL_CREAM 0
0 0 0 1 1 0 0 0
0 0 0 0 0 0 0 0
0 0 6 6 6 6 0 0
1 6 4 2 2 4 6 1
1 4 2 3 3 2 4 1
1 2 3 4 4 3 2 1
1 4 2 3 3 2 4 1
1 0 4 2 2 4 0 1
