MAP 47
MOVES 16
SCORE 23000
GOAL_BLOCK 7 21 / 8 21
GOAL_BISCUIT 19
GOAL_DOWN 0
GOAL_OBSTACLE 14
GOAL_CREAM 0
0 0 0 0 0 0 0 0
0 0 0 0 0 0 0 0
3 1 6 1 6 1 6 3
3 6 3 6 3 6 3 3
3 3 3 3 3 3 3 3
6 3 6 3 6 3 6 3
7 6 1 6 1 6 1 6
7 7 7 7 7 7 7 7 