MAP 48
MOVES 18
SCORE 23000
GOAL_BLOCK 6 21 / 7 21 / 8 21
GOAL_BISCUIT 20
GOAL_DOWN 0
GOAL_OBSTACLE 0
GOAL_CREAM 0
0 0 0 0 0 0 0 0
0 1 1 0 4 4 4 0
0 0 1 0 4 4 4 0
0 0 3 3 3 3 0 0
0 0 3 3 3 3 0 0
0 4 4 4 0 1 0 0
0 4 4 4 0 1 1 0
0 0 0 0 0 0 0 0
