MAP 49
MOVES 14
SCORE 23000
GOAL_BLOCK 8 36
GOAL_BISCUIT 0
GOAL_DOWN 0
GOAL_OBSTACLE 12
GOAL_CREAM 0
0 0 0 18 18 0 0 0
0 0 18 6 6 0 0 0
6 7 6 1 1 6 7 6
7 1 7 7 7 7 1 7
7 1 7 7 7 7 1 7
6 7 6 1 1 6 7 6
7 7 7 6 6 7 7 7
7 7 7 7 7 7 7 7
