MAP 50
MOVES 15
SCORE 23000
GOAL_BLOCK 6 24 / 7 24 / 8 24
GOAL_BISCUIT 0
GOAL_DOWN 0
GOAL_OBSTACLE 6
GOAL_CREAM 0
0 0 0 0 0 0 0 0
0 0 0 0 0 0 0 0
0 0 1 0 0 1 0 0
6 6 1 0 0 1 6 6
0 0 1 6 6 1 0 0
0 0 1 0 0 1 0 0
0 0 0 0 0 0 0 0
0 0 0 0 0 0 0 0
