MAP 51
MOVES 17
SCORE 23000
GOAL_BLOCK 
GOAL_BISCUIT 36
GOAL_DOWN 0
GOAL_OBSTACLE 0
GOAL_CREAM 0
0 0 0 0 0 0 0 0
0 0 0 0 0 0 0 0
4 4 1 2 2 1 4 4
4 4 1 1 1 1 4 4
4 4 1 1 1 1 4 4
3 3 1 2 2 1 3 3
3 3 4 4 4 4 3 3
3 3 4 4 4 4 3 3 