MAP 4
MOVES 16
SCORE 13000
GOAL_BLOCK 2 32 / 3 32
GOAL_BISCUIT 0
GOAL_DOWN 0
GOAL_OBSTACLE 10
GOAL_CREAM 8
1 1 6 10 13 6 1 1
1 1 6 13 10 6 1 1
7 7 6 10 13 6 7 7
7 7 6 6 6 6 7 7
7 7 7 7 7 7 7 7
8 8 7 8 8 7 8 8
1 1 8 7 7 8 1 1
1 1 7 7 7 7 1 1
