MAP 53
MOVES 20
SCORE 23000
GOAL_BLOCK 
GOAL_BISCUIT 38
GOAL_DOWN 0
GOAL_OBSTACLE 0
GOAL_CREAM 0
0 2 2 2 2 2 2 0
0 3 3 3 2 1 2 0
0 3 3 3 1 1 1 0
0 4 4 4 4 1 4 0
0 4 1 4 4 4 4 0
0 1 1 1 3 3 3 0
0 2 1 2 3 3 3 0
0 2 2 2 2 2 2 0 