MAP 54
MOVES 17
SCORE 23000
GOAL_BLOCK 3 27 / 4 27
GOAL_BISCUIT 0
GOAL_DOWN 0
GOAL_OBSTACLE 6
GOAL_CREAM 0
0 0 0 0 1 0 0 0
0 0 0 0 1 1 0 0
0 0 0 0 0 1 1 0
0 0 0 0 0 0 1 1
1 1 0 0 0 6 6 6
0 1 1 0 6 7 7 7
0 0 1 1 6 7 7 7
0 0 0 1 6 7 7 7
