MAP 55
MOVES 14
SCORE 23000
GOAL_BLOCK 6 21 / 7 21
GOAL_BISCUIT 16
GOAL_DOWN 0
GOAL_OBSTACLE 8
GOAL_CREAM 0
0 0 0 0 0 0 0 0
0 0 0 0 0 0 0 0
0 0 0 1 1 0 0 0
6 0 1 1 1 1 0 6
6 0 1 1 1 1 0 6
4 4 4 1 1 4 4 4
4 0 4 6 6 4 0 4
4 4 4 6 6 4 4 4
