MAP 57
MOVES 16
SCORE 23000
GOAL_BLOCK 
GOAL_BISCUIT 30
GOAL_DOWN 0
GOAL_OBSTACLE 0
GOAL_CREAM 0
0 0 0 2 2 0 0 0
0 0 0 2 2 0 0 0
0 2 2 3 3 2 2 0
0 2 2 3 3 2 2 0
0 0 0 2 2 4 4 2
1 1 1 2 2 4 4 2
1 1 1 1 1 2 2 0
1 1 1 1 1 2 2 0 