MAP 58
MOVES 17
SCORE 23000
GOAL_BLOCK 5 24 / 6 24
GOAL_BISCUIT 23
GOAL_DOWN 0
GOAL_OBSTACLE 0
GOAL_CREAM 0
0 0 0 0 0 0 0 0
0 0 0 0 0 3 3 0
0 0 0 0 4 4 3 0
0 0 0 4 4 4 2 0
0 0 4 4 4 2 2 1
0 3 4 4 2 2 1 1
0 3 3 2 2 1 1 1
0 0 0 0 1 1 1 1
