MAP 59
MOVES 17
SCORE 23000
GOAL_BLOCK 3 27 / 7 27
GOAL_BISCUIT 0
GOAL_DOWN 0
GOAL_OBSTACLE 0
GOAL_CREAM 7
1 1 7 7 7 7 7 7
1 7 7 7 7 7 7 7
7 7 7 7 7 7 7 7
7 7 7 8 7 7 7 1
8 0 8 21 8 0 8 1
7 7 7 8 7 7 7 8
1 7 7 0 7 7 7 0
1 1 7 0 7 7 7 0 