MAP 60
MOVES 17
SCORE 23000
GOAL_BLOCK 6 21 / 8 21
GOAL_BISCUIT 16
GOAL_DOWN 0
GOAL_OBSTACLE 16
GOAL_CREAM 0
1 1 0 0 0 0 0 0
1 6 6 0 3 3 3 0
0 6 6 6 3 3 3 0
0 0 6 6 6 3 3 0
0 4 4 6 6 6 0 0
0 4 4 4 6 6 6 0
0 4 4 4 0 6 6 1
0 0 0 0 0 0 1 1
