MAP 61
MOVES 17
SCORE 23000
GOAL_BLOCK 5 18 / 7 18
GOAL_BISCUIT 0
GOAL_DOWN 0
GOAL_OBSTACLE 10
GOAL_CREAM 6
0 0 0 0 0 0 0 0
0 0 0 0 0 0 0 0
0 0 6 0 0 6 0 0
0 6 0 6 6 0 6 0
6 0 6 0 0 6 0 6
0 0 8 0 0 8 0 0
1 8 0 8 8 0 8 1
1 1 0 0 0 0 1 1
