MAP 15
MOVES 18
SCORE 9000
GOAL_BLOCK 3 24 / 4 24
GOAL_BISCUIT 32
GOAL_DOWN 0
GOAL_OBSTACLE 0
GOAL_CREAM 4
33 14 11 1 1 11 13 34
11 13 12 1 1 12 14 11
33 12 14 1 1 13 12 34
1 1 1 1 1 1 1 1
2 2 2 2 2 2 2 2
2 2 2 2 2 2 2 2
2 2 2 2 2 2 2 2
2 2 2 2 2 2 2 2
