MAP 63
MOVES 30
SCORE 23000
GOAL_BLOCK 3 24 / 4 24
GOAL_BISCUIT 0
GOAL_DOWN 0
GOAL_OBSTACLE 4
GOAL_CREAM 2
0 0 0 1 1 0 0 0
0 0 0 1 1 0 0 0
0 0 1 1 1 1 0 0
1 1 1 0 0 1 1 1
6 0 6 0 0 6 0 6
0 0 0 0 0 0 0 0
0 0 0 8 8 0 0 0
0 0 0 0 0 0 0 0
