MAP 64
MOVES 18
SCORE 23000
GOAL_BLOCK 
GOAL_BISCUIT 36
GOAL_DOWN 0
GOAL_OBSTACLE 0
GOAL_CREAM 0
0 0 0 0 0 0 0 0
0 0 0 0 0 0 0 0
2 2 1 4 4 1 2 2
2 1 1 4 4 1 1 2
3 3 1 4 4 1 3 3
3 1 1 4 4 1 1 3
3 3 2 4 4 2 3 3
3 3 2 2 2 2 3 3 