MAP 66
MOVES 18
SCORE 23000
GOAL_BLOCK 7 21 / 8 21
GOAL_BISCUIT 0
GOAL_DOWN 0
GOAL_OBSTACLE 0
GOAL_CREAM 8
0 0 0 1 1 0 0 0
0 0 0 1 1 0 0 0
0 0 0 8 8 0 0 0
0 0 0 8 8 0 0 0
0 8 8 7 7 8 8 0
1 7 7 7 7 7 7 1
1 7 7 7 7 7 7 1
1 7 7 7 7 7 7 1
