MAP 0
MOVES 16
SCORE 23000
GOAL_BLOCK 6 30 / 7 30
GOAL_BISCUIT 0
GOAL_DOWN 0
GOAL_OBSTACLE 12
GOAL_CREAM 0
0 0 0 0 0 0 0 0
0 0 0 0 0 0 0 0
0 0 0 0 0 0 0 0
0 0 0 0 0 0 0 0
6 0 6 0 0 6 0 6
6 0 0 6 6 0 0 6
0 6 0 0 0 0 6 0
6 0 0 0 0 0 0 6
