MAP 68
MOVES 16
SCORE 23000
GOAL_BLOCK 5 30
GOAL_BISCUIT 32
GOAL_DOWN 0
GOAL_OBSTACLE 0
GOAL_CREAM 0
0 0 0 1 1 0 0 0
0 0 0 1 1 2 2 2
0 4 4 3 3 2 2 2
0 4 4 3 3 4 4 0
0 4 4 2 2 4 4 0
3 3 3 2 2 4 4 0
3 3 3 1 1 0 0 0
0 0 0 1 1 0 0 0
