MAP 71
MOVES 18
SCORE 23000
GOAL_BLOCK 6 30 / 7 21
GOAL_BISCUIT 0
GOAL_DOWN 0
GOAL_OBSTACLE 0
GOAL_CREAM 10
1 0 0 1 1 0 0 1
0 0 0 0 0 0 0 0
0 0 0 0 0 0 0 0
1 8 8 0 0 8 8 1
1 1 7 8 8 7 1 1
1 8 8 7 7 8 8 1
1 7 7 7 7 7 7 1
1 7 7 7 7 7 7 1 