MAP 72
MOVES 18
SCORE 23000
GOAL_BLOCK 3 21 / 4 21
GOAL_BISCUIT 0
GOAL_DOWN 0
GOAL_OBSTACLE 12
GOAL_CREAM 4
1 0 0 0 0 0 0 1
0 0 0 0 0 0 0 0
8 6 1 6 6 1 6 8
0 0 6 0 0 6 0 0
0 0 0 0 0 0 0 0
8 6 1 6 6 1 6 8
7 7 6 7 7 6 7 7
1 7 7 7 7 7 7 1
