MAP 73
MOVES 18
SCORE 23000
GOAL_BLOCK 6 24 / 7 24
GOAL_BISCUIT 0
GOAL_DOWN 4
GOAL_OBSTACLE 6
GOAL_CREAM 2
1 1 5 0 0 5 1 1
1 1 0 0 0 0 1 1
1 5 6 0 0 6 5 1
1 8 6 0 0 6 8 1
0 6 0 0 0 0 6 0
0 0 0 0 0 0 0 0
0 0 0 0 0 0 0 0
1 1 0 0 0 0 1 1
