MAP 16
MOVES 18
SCORE 11000
GOAL_BLOCK 0 27 / 3 27
GOAL_BISCUIT 0
GOAL_DOWN 0
GOAL_OBSTACLE 10
GOAL_CREAM 10
1 1 1 0 0 1 1 1
1 1 8 0 0 8 1 1
1 6 8 14 13 8 6 1
6 6 8 13 14 8 6 6
1 7 8 34 33 8 7 1
7 6 6 7 7 6 6 7
1 1 1 7 7 1 1 1
1 1 7 7 7 7 1 1
