MAP 94
MOVES 18
SCORE 23000
GOAL_BLOCK 5 21 / 6 21
GOAL_BISCUIT 0
GOAL_DOWN 0
GOAL_OBSTACLE 18
GOAL_CREAM 0
1 6 6 16 15 6 6 1
1 6 6 15 17 6 6 1
6 6 6 16 15 6 6 6
7 7 6 6 6 6 7 7
7 7 7 1 1 7 7 7
7 7 7 7 7 7 7 7
7 7 7 7 7 7 7 7
7 7 1 1 1 1 7 7
