MAP 74
MOVES 18
SCORE 23000
GOAL_BLOCK 
GOAL_BISCUIT 32
GOAL_DOWN 0
GOAL_OBSTACLE 0
GOAL_CREAM 4
1 1 1 0 0 1 1 1
1 2 2 2 2 0 0 1
3 3 3 3 2 2 2 2
3 3 3 3 0 8 8 0
0 8 8 0 4 4 4 4
2 2 2 2 4 4 4 4
1 0 0 2 2 2 2 1
1 1 0 0 0 0 1 1
