MAP 76
MOVES 16
SCORE 23000
GOAL_BLOCK 
GOAL_BISCUIT 0
GOAL_DOWN 2
GOAL_OBSTACLE 10
GOAL_CREAM 4
0 5 1 1 1 1 5 0
0 0 0 1 1 0 0 0
0 6 0 0 0 0 6 0
6 0 6 0 0 6 0 6
0 8 0 8 8 0 8 0
0 0 6 0 0 6 0 0
0 0 0 6 6 0 0 0
1 0 0 0 0 0 0 1
