MAP 77
MOVES 15
SCORE 23000
GOAL_BLOCK 
GOAL_BISCUIT 46
GOAL_DOWN 0
GOAL_OBSTACLE 8
GOAL_CREAM 2
1 3 3 3 3 3 3 1
3 3 3 3 3 3 3 3
3 3 0 6 6 0 3 3
0 6 6 42 42 6 6 0
4 4 0 6 6 0 4 4
4 4 4 4 4 4 4 4
4 4 4 4 4 4 4 4
4 4 4 4 4 4 4 4
