MAP 78
MOVES 18
SCORE 23000
GOAL_BLOCK 
GOAL_BISCUIT 28
GOAL_DOWN 0
GOAL_OBSTACLE 0
GOAL_CREAM 0
0 0 0 0 0 0 0 0
0 0 0 0 0 0 0 0
0 0 0 0 0 0 0 0
1 1 1 0 0 1 1 1
2 2 1 0 0 1 2 2
2 4 2 4 4 2 4 2
2 4 4 4 4 4 4 2
2 4 4 4 4 4 4 2
