MAP 79
MOVES 16
SCORE 23000
GOAL_BLOCK 7 24 / 8 24
GOAL_BISCUIT 0
GOAL_DOWN 0
GOAL_OBSTACLE 0
GOAL_CREAM 8
1 0 0 0 0 0 0 1
1 0 0 0 0 0 0 1
0 0 8 0 0 8 0 0
0 0 0 0 0 0 0 0
0 8 0 0 0 0 8 0
0 0 8 0 0 8 0 0
1 0 0 8 8 0 0 1
1 0 0 0 0 0 0 1
