MAP 81
MOVES 18
SCORE 23000
GOAL_BLOCK 6 21
GOAL_BISCUIT 8
GOAL_DOWN 0
GOAL_OBSTACLE 6
GOAL_CREAM 6
0 0 1 0 0 1 0 0
0 0 1 0 0 1 0 0
0 0 0 0 0 0 0 0
0 4 4 8 8 4 4 0
0 4 4 0 0 4 4 0
1 6 8 7 7 8 6 1
1 6 7 0 0 7 6 1
1 6 7 8 8 7 6 1
