MAP 82
MOVES 20
SCORE 23000
GOAL_BLOCK 
GOAL_BISCUIT 22
GOAL_DOWN 0
GOAL_OBSTACLE 0
GOAL_CREAM 6
1 1 0 0 0 0 1 1
1 0 0 0 0 0 0 1
0 0 8 4 4 8 0 0
0 8 1 4 4 1 8 0
0 4 4 4 4 4 4 0
0 4 4 1 1 4 4 0
1 4 8 4 4 8 4 1
1 1 4 4 4 4 1 1
