MAP 83
MOVES 18
SCORE 23000
GOAL_BLOCK 
GOAL_BISCUIT 0
GOAL_DOWN 4
GOAL_OBSTACLE 4
GOAL_CREAM 2
0 5 0 0 0 0 5 0
0 6 0 0 0 0 6 0
0 6 0 5 5 0 6 0
1 0 1 8 8 1 0 1
0 0 0 0 0 0 0 0
0 0 0 0 0 0 0 0
0 0 0 0 0 0 0 0
0 0 0 0 0 0 0 0 