MAP 84
MOVES 18
SCORE 23000
GOAL_BLOCK 3 24 / 4 24
GOAL_BISCUIT 20
GOAL_DOWN 0
GOAL_OBSTACLE 0
GOAL_CREAM 0
1 1 0 1 1 0 1 1
1 0 0 0 0 0 0 1
0 4 0 4 4 0 4 0
0 0 4 0 0 4 0 0
0 4 4 4 4 4 4 0
0 4 4 0 0 4 4 0
1 4 0 4 4 0 4 1
1 1 0 0 0 0 1 1 