MAP 9
MOVES 18
SCORE 9000
GOAL_BLOCK 
GOAL_BISCUIT 16
GOAL_DOWN 2
GOAL_OBSTACLE 0
GOAL_CREAM 10
1 1 5 0 0 5 1 1
1 0 8 8 8 8 0 1
0 0 8 21 21 8 0 0
0 0 8 8 8 8 0 0
0 0 0 0 0 0 0 0
0 0 0 0 0 0 0 0
2 2 2 2 2 2 2 2
2 2 2 2 2 2 2 2
