MAP 85
MOVES 18
SCORE 23000
GOAL_BLOCK 
GOAL_BISCUIT 14
GOAL_DOWN 2
GOAL_OBSTACLE 0
GOAL_CREAM 6
1 0 5 0 0 5 0 1
0 0 0 0 0 0 0 0
0 0 0 0 0 0 0 0
8 0 8 0 0 8 0 8
4 8 4 0 0 4 8 4
4 4 4 0 0 4 4 4
4 0 4 0 0 4 0 4
0 0 1 0 0 1 0 0
