MAP 86
MOVES 16
SCORE 23000
GOAL_BLOCK 
GOAL_BISCUIT 12
GOAL_DOWN 0
GOAL_OBSTACLE 0
GOAL_CREAM 6
0 0 0 0 0 0 0 0
0 0 0 0 0 0 0 0
1 1 1 1 1 1 1 1
0 2 2 2 2 2 2 0
0 2 2 8 8 2 2 0
0 2 8 41 41 8 2 0
0 0 7 0 0 7 0 0
0 0 7 7 7 7 0 0
