MAP 87
MOVES 16
SCORE 23000
GOAL_BLOCK 
GOAL_BISCUIT 16
GOAL_DOWN 0
GOAL_OBSTACLE 0
GOAL_CREAM 8
0 0 1 1 1 1 0 0
0 0 0 1 1 0 0 0
8 0 0 0 0 0 0 8
39 0 0 4 4 0 0 40
40 0 4 4 4 4 0 39
8 3 3 4 4 3 3 8
0 3 3 1 1 3 3 0
0 0 1 1 1 1 0 0
