MAP 90
MOVES 16
SCORE 23000
GOAL_BLOCK 
GOAL_BISCUIT 12
GOAL_DOWN 0
GOAL_OBSTACLE 8
GOAL_CREAM 2
0 0 1 0 0 1 0 0
0 0 0 0 0 0 0 0
6 6 0 0 0 0 6 6
1 0 4 4 4 4 0 1
22 8 4 4 4 4 8 22
1 0 4 4 4 4 0 1
6 6 0 0 0 0 6 6
0 0 0 1 1 0 0 0
