MAP 91
MOVES 14
SCORE 23000
GOAL_BLOCK 8 30
GOAL_BISCUIT 0
GOAL_DOWN 2
GOAL_OBSTACLE 6
GOAL_CREAM 2
1 5 0 0 0 0 5 1
0 0 0 0 0 0 0 0
0 6 0 0 0 0 6 0
1 41 6 0 0 6 41 1
0 6 0 0 0 0 6 0
0 0 0 0 0 0 0 0
1 0 0 0 0 0 0 1
1 0 0 0 0 0 0 1
