MAP 4
MOVES 18
SCORE 23000
GOAL_BLOCK 8 30
GOAL_BISCUIT 14
GOAL_DOWN 0
GOAL_OBSTACLE 0
GOAL_CREAM 6
1 1 0 0 0 0 1 1
1 1 0 0 0 0 1 1
0 0 0 0 0 0 0 0
0 4 4 0 0 4 4 0
0 4 4 8 8 4 4 0
0 8 0 4 4 0 8 0
1 1 8 4 4 8 1 1
1 1 0 4 4 0 1 1
