MAP 5
MOVES 20
SCORE 23000
GOAL_BLOCK 6 24 / 8 24
GOAL_BISCUIT 0
GOAL_DOWN 0
GOAL_OBSTACLE 20
GOAL_CREAM 0
1 16 14 1 1 17 18 1
1 14 16 1 1 18 17 1
6 16 16 6 6 18 18 6
6 6 6 6 6 6 6 6
7 7 7 6 6 7 7 7
6 7 6 7 7 6 7 6
1 1 7 6 6 7 1 1
1 1 7 7 7 7 1 1 