MAP 6
MOVES 20
SCORE 23000
GOAL_BLOCK 6 24 / 8 24
GOAL_BISCUIT 0
GOAL_DOWN 0
GOAL_OBSTACLE 12
GOAL_CREAM 4
1 1 15 18 13 16 1 1
1 16 14 15 14 13 17 1
6 17 6 18 13 6 14 6
7 6 7 6 6 7 6 7
7 6 7 6 6 7 6 7
7 7 7 7 7 7 7 7
7 8 7 8 8 7 8 7
7 7 1 7 7 1 7 7
