MAP 17
MOVES 16
SCORE 10000
GOAL_BLOCK 
GOAL_BISCUIT 0
GOAL_DOWN 2
GOAL_OBSTACLE 6
GOAL_CREAM 8
1 5 0 0 0 0 5 1
1 6 0 0 0 0 6 1
1 6 0 0 0 0 6 1
1 6 0 0 0 0 6 1
1 0 8 0 0 8 0 1
1 8 0 8 8 0 8 1
1 0 8 0 0 8 0 1
1 7 1 7 7 1 7 1
