MAP 8
MOVES 16
SCORE 23000
GOAL_BLOCK 3 30
GOAL_BISCUIT 0
GOAL_DOWN 0
GOAL_OBSTACLE 16
GOAL_CREAM 2
7 6 0 1 1 0 6 7
7 6 0 13 13 0 6 7
7 6 13 6 6 13 6 7
1 7 6 7 7 6 7 1
1 6 7 7 7 7 6 1
7 7 6 7 7 6 7 7
7 41 7 6 6 7 41 7
7 7 7 1 1 7 7 7
