MAP 10
MOVES 16
SCORE 23000
GOAL_BLOCK 
GOAL_BISCUIT 28
GOAL_DOWN 0
GOAL_OBSTACLE 12
GOAL_CREAM 0
1 0 0 1 1 0 0 1
0 0 0 1 1 0 0 0
0 0 0 1 1 0 0 0
6 2 2 6 6 2 2 6
6 2 2 3 3 2 2 6
6 3 3 4 4 3 3 6
6 3 3 4 4 3 3 6
6 4 4 4 4 4 4 6 