MAP 12
MOVES 16
SCORE 23000
GOAL_BLOCK 
GOAL_BISCUIT 30
GOAL_DOWN 0
GOAL_OBSTACLE 0
GOAL_CREAM 0
1 1 1 1 1 1 1 1
0 0 0 0 0 0 0 0
0 2 3 2 2 3 2 0
0 3 4 3 3 4 3 0
0 2 3 4 4 3 2 0
0 3 4 3 3 4 3 0
1 2 3 2 2 3 2 1
1 1 0 0 0 0 1 1 