MAP 13
MOVES 16
SCORE 23000
GOAL_BLOCK 
GOAL_BISCUIT 0
GOAL_DOWN 4
GOAL_OBSTACLE 12
GOAL_CREAM 4
1 0 0 0 0 0 0 1
0 0 0 5 5 0 0 0
0 5 0 6 6 0 5 0
6 8 6 0 0 6 8 6
6 8 6 0 0 6 8 6
0 0 0 6 6 0 0 0
0 0 0 0 0 0 0 0
1 0 0 0 0 0 0 1
