MAP 95
MOVES 18
SCORE 23000
GOAL_BLOCK 
GOAL_BISCUIT 16
GOAL_DOWN 0
GOAL_OBSTACLE 0
GOAL_CREAM 6
1 0 0 1 1 0 0 1
0 0 0 0 0 0 0 0
0 0 0 0 0 0 0 0
0 4 8 0 0 8 4 0
0 4 8 4 4 8 4 0
1 3 4 4 4 4 3 1
1 1 3 8 8 3 1 1
1 1 1 3 3 1 1 1
