MAP 14
MOVES 18
SCORE 23000
GOAL_BLOCK 
GOAL_BISCUIT 0
GOAL_DOWN 0
GOAL_OBSTACLE 0
GOAL_CREAM 14
7 1 7 1 1 7 1 7
8 20 8 0 0 8 20 8
7 8 7 8 8 7 8 7
7 7 7 7 7 7 7 7
7 7 7 7 7 7 7 7
7 8 7 7 7 7 8 7
8 7 8 7 7 8 7 8
7 7 7 7 7 7 7 7
