MAP 16
MOVES 18
SCORE 23000
GOAL_BLOCK 6 21 / 7 21
GOAL_BISCUIT 0
GOAL_DOWN 2
GOAL_OBSTACLE 0
GOAL_CREAM 6
1 1 1 0 0 1 1 1
1 1 5 0 0 5 1 1
1 8 0 8 8 0 8 1
0 0 8 0 0 8 0 0
1 0 0 0 0 0 0 1
0 0 0 0 0 0 0 0
1 1 1 0 0 1 1 1
1 1 0 0 0 0 1 1
