MAP 17
MOVES 16
SCORE 23000
GOAL_BLOCK 
GOAL_BISCUIT 8
GOAL_DOWN 0
GOAL_OBSTACLE 14
GOAL_CREAM 0
1 0 0 0 0 0 0 1
1 0 0 0 0 0 0 1
1 0 6 6 6 6 0 1
1 0 6 4 4 6 0 1
1 0 6 6 6 6 0 1
1 0 6 3 3 6 0 1
1 0 6 3 3 6 0 1
1 0 1 3 3 1 0 1 