MAP 8
MOVES 18
SCORE 12000
GOAL_BLOCK 0 24 / 2 24
GOAL_BISCUIT 0
GOAL_DOWN 0
GOAL_OBSTACLE 12
GOAL_CREAM 6
0 0 0 1 1 0 0 0
0 0 0 0 0 0 0 0
0 0 0 0 0 0 0 0
1 8 0 8 8 0 8 1
1 0 8 0 0 8 0 1
6 6 7 7 7 7 6 6
6 7 7 7 7 7 7 6
6 6 6 1 1 6 6 6
