MAP 96
MOVES 16
SCORE 23000
GOAL_BLOCK 
GOAL_BISCUIT 32
GOAL_DOWN 0
GOAL_OBSTACLE 0
GOAL_CREAM 0
1 3 3 3 1 1 1 1
1 3 21 3 0 3 3 3
1 3 3 3 0 3 21 3
1 0 0 1 1 3 3 3
4 4 4 1 1 0 0 1
4 21 4 0 4 4 4 1
4 4 4 0 4 21 4 1
1 1 1 1 4 4 4 1
