MAP 19
MOVES 16
SCORE 23000
GOAL_BLOCK 
GOAL_BISCUIT 26
GOAL_DOWN 0
GOAL_OBSTACLE 16
GOAL_CREAM 0
0 0 0 0 0 0 0 0
0 0 0 0 0 0 0 0
1 0 6 6 6 6 0 1
2 6 2 2 2 2 6 2
2 6 2 2 2 2 6 2
1 6 6 4 4 6 6 1
3 3 6 4 4 6 3 3
3 3 6 4 4 6 3 3 