MAP 20
MOVES 15
SCORE 23000
GOAL_BLOCK 
GOAL_BISCUIT 32
GOAL_DOWN 0
GOAL_OBSTACLE 0
GOAL_CREAM 0
1 1 1 2 2 1 1 1
1 1 0 2 2 0 1 1
1 0 4 4 4 4 0 1
3 3 3 3 3 3 3 3
3 3 3 3 3 3 3 3
1 0 4 4 4 4 0 1
1 1 0 2 2 0 1 1
1 1 1 2 2 1 1 1
