MAP 22
MOVES 18
SCORE 23000
GOAL_BLOCK 
GOAL_BISCUIT 0
GOAL_DOWN 2
GOAL_OBSTACLE 24
GOAL_CREAM 6
6 5 6 6 6 5 6 6
20 0 0 0 0 0 0 0
6 6 6 6 6 6 6 6
7 8 7 7 8 7 7 7
7 7 8 7 7 8 7 7
7 6 7 8 6 7 8 7
7 6 6 7 6 6 7 7
7 6 1 6 6 1 6 7
