MAP 23
MOVES 17
SCORE 23000
GOAL_BLOCK 
GOAL_BISCUIT 0
GOAL_DOWN 2
GOAL_OBSTACLE 0
GOAL_CREAM 8
0 0 1 0 0 1 0 0
0 0 1 0 0 1 0 0
0 8 5 8 8 5 8 0
0 0 8 0 0 8 0 0
0 0 0 0 0 0 0 0
1 1 0 8 8 0 1 1
0 0 0 0 0 0 0 0
0 0 0 0 0 0 0 0
