MAP 24
MOVES 17
SCORE 23000
GOAL_BLOCK 5 24 / 7 24
GOAL_BISCUIT 0
GOAL_DOWN 0
GOAL_OBSTACLE 14
GOAL_CREAM 0
0 0 0 0 0 0 0 0
0 0 0 0 0 0 0 0
0 1 0 1 1 0 1 0
6 6 6 7 7 6 6 6
6 0 6 7 7 6 0 6
7 1 7 1 1 7 1 7
7 7 6 7 7 6 7 7
7 7 7 6 6 7 7 7
