MAP 97
MOVES 16
SCORE 23000
GOAL_BLOCK 
GOAL_BISCUIT 16
GOAL_DOWN 0
GOAL_OBSTACLE 16
GOAL_CREAM 0
1 0 0 0 0 0 0 1
0 0 0 0 0 0 0 0
0 6 4 6 6 4 6 0
0 6 4 6 6 4 6 0
0 1 1 1 1 1 1 0
1 3 6 4 4 6 3 1
6 3 6 4 4 6 3 6
1 3 6 4 4 6 3 1
