MAP 98
MOVES 17
SCORE 23000
GOAL_BLOCK 
GOAL_BISCUIT 0
GOAL_DOWN 0
GOAL_OBSTACLE 16
GOAL_CREAM 4
0 8 8 0 0 8 8 0
0 0 0 0 0 0 0 0
0 0 6 6 6 6 0 0
0 0 0 6 6 0 0 0
6 0 0 0 0 0 0 6
6 0 0 0 0 0 0 6
6 6 0 0 0 0 6 6
1 6 0 0 0 0 6 1
