MAP 73
MOVES 15
SCORE 23000
GOAL_BLOCK 
GOAL_BISCUIT 0
GOAL_DOWN 2
GOAL_OBSTACLE 0
GOAL_CREAM 4
1 1 5 0 0 5 1 1
1 1 0 0 0 0 1 1
1 0 0 0 0 0 0 1
0 0 0 0 0 0 0 0
8 0 0 8 8 0 0 8
7 7 7 7 7 7 7 7
7 7 7 7 7 7 7 7
1 1 7 7 7 7 1 1
