MAP 99
MOVES 17
SCORE 23000
GOAL_BLOCK 
GOAL_BISCUIT 12
GOAL_DOWN 0
GOAL_OBSTACLE 0
GOAL_CREAM 6
0 0 0 0 0 0 0 0
1 0 0 0 0 0 0 1
8 1 0 0 0 0 1 8
0 8 1 0 0 1 8 0
0 0 8 0 0 8 0 0
0 0 4 4 4 4 0 0
1 0 4 4 4 4 0 1
1 1 4 4 4 4 1 1
