MAP 12
MOVES 18
SCORE 17000
GOAL_BLOCK 
GOAL_BISCUIT 24
GOAL_DOWN 0
GOAL_OBSTACLE 8
GOAL_CREAM 6
1 1 1 1 1 1 1 1
2 2 2 2 2 2 2 2
2 2 2 2 2 2 2 2
2 2 2 2 2 2 2 2
6 6 6 6 6 6 6 6
7 7 7 8 8 7 7 7
1 7 7 8 8 7 7 1
1 1 7 8 8 7 1 1
