MAP 60
MOVES 16
SCORE 23000
GOAL_BLOCK 
GOAL_BISCUIT 0
GOAL_DOWN 0
GOAL_OBSTACLE 10
GOAL_CREAM 4
1 1 0 0 0 0 0 0
1 0 0 0 0 6 0 0
0 0 0 0 6 8 6 0
0 0 0 6 42 6 0 0
0 0 6 42 6 0 0 0
0 6 8 6 0 0 0 0
0 0 6 0 0 0 0 1
0 0 0 0 0 0 1 1
