MAP 100
MOVES 16
SCORE 23000
GOAL_BLOCK 2 20 / 6 20
GOAL_BISCUIT 0
GOAL_DOWN 0
GOAL_OBSTACLE 11
GOAL_CREAM 4
0 0 0 0 0 17 16 1
6 8 0 0 16 12 12 10
7 6 6 8 8 12 10 12
7 7 7 7 6 6 8 10
7 6 7 7 7 7 6 6
7 7 7 6 6 7 7 7
7 7 7 7 7 7 6 7
1 7 7 7 7 7 7 7
