MAP 25
MOVES 18
SCORE 23000
GOAL_BLOCK 0 24 / 2 24
GOAL_BISCUIT 0
GOAL_DOWN 0
GOAL_OBSTACLE 10
GOAL_CREAM 4
1 1 1 12 10 1 1 1
6 1 12 10 12 12 1 6
6 6 7 6 6 7 6 6
7 7 6 7 7 6 7 7
7 8 7 8 8 7 8 7
7 7 7 7 7 7 7 7
7 7 7 7 7 7 7 7
1 7 7 7 7 7 7 1
