MAP 26
MOVES 15
SCORE 23000
GOAL_BLOCK 
GOAL_BISCUIT 40
GOAL_DOWN 0
GOAL_OBSTACLE 0
GOAL_CREAM 0
0 2 1 2 2 1 2 0
0 2 2 2 2 2 2 0
0 3 1 3 3 1 3 0
0 3 3 3 3 3 3 0
0 3 1 3 3 1 3 0
0 4 4 4 4 4 4 0
0 4 1 4 4 1 4 0
0 4 4 4 4 4 4 0 