MAP 28
MOVES 16
SCORE 23000
GOAL_BLOCK 
GOAL_BISCUIT 34
GOAL_DOWN 0
GOAL_OBSTACLE 10
GOAL_CREAM 0
1 1 0 0 0 0 1 1
0 0 0 0 0 0 0 0
6 2 2 2 2 2 2 6
6 6 2 6 6 2 6 6
4 4 4 6 6 4 4 4
4 4 4 3 3 4 4 4
4 4 4 3 3 4 4 4
1 1 3 3 3 3 1 1
