MAP 29
MOVES 16
SCORE 23000
GOAL_BLOCK 
GOAL_BISCUIT 20
GOAL_DOWN 0
GOAL_OBSTACLE 0
GOAL_CREAM 8
1 0 0 0 0 0 0 1
1 0 0 0 0 0 0 1
1 1 0 0 0 0 1 1
1 2 8 3 3 8 2 1
1 2 8 3 3 8 2 1
0 8 4 4 4 4 8 0
0 2 4 2 2 4 2 0
0 8 4 1 1 4 8 0
