MAP 30
MOVES 16
SCORE 23000
GOAL_BLOCK 0 20 / 6 20
GOAL_BISCUIT 0
GOAL_DOWN 0
GOAL_OBSTACLE 18
GOAL_CREAM 0
0 0 0 1 1 0 0 0
0 0 0 1 1 0 0 0
1 6 0 0 0 0 6 1
7 6 0 6 6 0 6 7
7 7 7 6 6 7 7 7
7 6 7 1 1 7 6 7
6 7 6 7 7 6 7 6
7 6 7 6 6 7 6 7
