MAP 31
MOVES 16
SCORE 23000
GOAL_BLOCK 
GOAL_BISCUIT 0
GOAL_DOWN 0
GOAL_OBSTACLE 16
GOAL_CREAM 7
17 18 1 1 1 1 1 1
18 17 6 7 1 1 1 1
17 18 6 7 8 7 1 1
6 6 6 7 8 7 6 7
7 7 7 7 8 7 6 7
8 8 8 8 7 7 6 7
7 7 7 7 7 7 6 7
6 6 6 6 6 6 6 7
