MAP 18
MOVES 18
SCORE 20000
GOAL_BLOCK 
GOAL_BISCUIT 32
GOAL_DOWN 0
GOAL_OBSTACLE 4
GOAL_CREAM 0
1 0 0 0 1 1 1 1
1 2 2 2 2 2 2 0
1 2 2 2 2 2 2 0
1 2 2 6 6 2 2 0
0 2 2 6 6 2 2 1
0 2 2 2 2 2 2 1
0 2 2 2 2 2 2 1
1 1 1 1 0 0 0 1
