MAP 32
MOVES 13
SCORE 23000
GOAL_BLOCK 
GOAL_BISCUIT 24
GOAL_DOWN 0
GOAL_OBSTACLE 0
GOAL_CREAM 0
0 0 0 0 0 0 1 1
0 0 0 0 0 0 1 1
0 3 3 3 2 0 0 1
0 3 3 3 2 2 0 0
0 3 3 3 4 4 4 0
1 0 2 2 4 4 4 0
1 1 0 2 4 4 4 0
1 1 0 0 0 0 0 0
