MAP 33
MOVES 15
SCORE 23000
GOAL_BLOCK 2 20 / 5 20 / 8 20
GOAL_BISCUIT 0
GOAL_DOWN 0
GOAL_OBSTACLE 12
GOAL_CREAM 0
0 0 0 1 1 0 0 0
0 0 0 1 1 0 0 0
0 6 0 1 1 0 6 0
0 6 0 1 1 0 6 0
0 6 0 0 0 0 6 0
0 0 0 6 6 0 0 0
0 0 0 6 6 0 0 0
0 0 0 6 6 0 0 0
