MAP 34
MOVES 17
SCORE 23000
GOAL_BLOCK 6 20 / 7 20
GOAL_BISCUIT 24
GOAL_DOWN 0
GOAL_OBSTACLE 0
GOAL_CREAM 0
0 0 0 0 0 0 0 0
0 0 0 0 0 0 0 0
1 1 0 2 2 0 1 1
0 1 1 2 2 1 1 0
0 4 1 1 1 1 4 0
0 4 4 3 3 4 4 0
0 3 3 4 4 3 3 0
0 2 2 2 2 2 2 0
