MAP 36
MOVES 15
SCORE 23000
GOAL_BLOCK 
GOAL_BISCUIT 24
GOAL_DOWN 0
GOAL_OBSTACLE 0
GOAL_CREAM 4
0 0 3 0 0 3 0 0
0 8 3 0 0 3 8 0
0 0 3 0 0 3 0 0
0 2 3 4 4 3 2 0
0 2 0 4 4 0 2 0
0 2 8 4 4 8 2 0
1 2 0 4 4 0 2 1
1 1 0 0 0 0 1 1
