MAP 37
MOVES 16
SCORE 23000
GOAL_BLOCK 
GOAL_BISCUIT 0
GOAL_DOWN 2
GOAL_OBSTACLE 4
GOAL_CREAM 4
0 5 0 5 0 0 0 0
0 0 0 0 0 0 0 0
0 0 0 0 0 0 0 0
8 6 8 6 1 1 1 1
6 8 6 8 1 1 1 1
7 7 7 7 7 7 7 7
7 7 7 7 7 7 7 7
7 7 7 7 7 7 7 7
