MAP 39
MOVES 18
SCORE 23000
GOAL_BLOCK 0 25 / 2 25
GOAL_BISCUIT 0
GOAL_DOWN 0
GOAL_OBSTACLE 10
GOAL_CREAM 2
0 0 1 0 0 1 0 0
0 1 1 0 0 1 1 0
1 1 0 0 0 0 1 1
0 0 0 0 0 0 0 0
0 0 0 8 8 0 0 0
6 6 6 1 1 6 6 6
0 0 6 6 6 6 0 0
0 0 0 0 0 0 0 0
