MAP 40
MOVES 16
SCORE 23000
GOAL_BLOCK 5 20 / 8 20
GOAL_BISCUIT 0
GOAL_DOWN 0
GOAL_OBSTACLE 12
GOAL_CREAM 4
1 0 0 0 0 0 0 0
0 0 0 0 0 0 0 0
0 0 0 0 0 0 1 1
6 6 0 6 6 6 1 1
1 1 0 0 0 6 8 8
1 1 6 6 0 6 6 6
8 8 6 0 0 0 0 0
0 0 0 0 0 0 0 1
