MAP 41
MOVES 16
SCORE 23000
GOAL_BLOCK 
GOAL_BISCUIT 16
GOAL_DOWN 0
GOAL_OBSTACLE 6
GOAL_CREAM 4
0 0 0 0 0 1 0 0
0 0 3 3 0 1 0 0
0 6 3 3 6 1 1 1
2 2 0 8 0 6 0 0
2 2 8 22 8 2 2 0
0 6 0 8 0 2 2 0
1 1 6 3 3 6 0 0
1 1 0 3 3 0 0 0
