MAP 42
MOVES 17
SCORE 23000
GOAL_BLOCK 6 30
GOAL_BISCUIT 0
GOAL_DOWN 0
GOAL_OBSTACLE 12
GOAL_CREAM 0
7 6 16 18 16 7 7 7
7 6 16 16 6 1 1 6
7 7 6 6 7 6 6 7
6 1 1 1 6 7 7 7
6 1 1 1 6 7 7 7
7 7 7 7 7 7 7 7
7 7 7 7 7 1 1 7
7 7 7 7 7 7 7 7
