MAP 19
MOVES 19
SCORE 20000
GOAL_BLOCK 
GOAL_BISCUIT 32
GOAL_DOWN 0
GOAL_OBSTACLE 0
GOAL_CREAM 12
0 0 0 0 0 0 10 0
0 0 0 0 0 0 0 10
1 8 8 8 8 8 30 1
2 2 2 2 2 2 2 2
2 2 2 2 2 2 2 2
1 8 8 8 8 8 8 1
2 2 2 2 2 2 2 2
2 2 2 2 2 2 2 2
