MAP 48
MOVES 20
SCORE 23000
GOAL_BLOCK 7 25 / 8 25
GOAL_BISCUIT 0
GOAL_DOWN 0
GOAL_OBSTACLE 0
GOAL_CREAM 10
0 0 0 0 0 0 0 0
0 1 1 0 8 0 0 0
0 0 1 8 0 8 0 0
0 0 8 0 0 0 8 0
0 8 0 0 0 8 0 0
0 0 8 0 8 1 0 0
0 0 0 8 0 1 1 0
0 0 0 0 0 0 0 0
