MAP 49
MOVES 16
SCORE 23000
GOAL_BLOCK 
GOAL_BISCUIT 0
GOAL_DOWN 2
GOAL_OBSTACLE 8
GOAL_CREAM 6
0 0 5 0 0 5 0 0
0 0 0 0 0 0 0 0
0 8 8 1 1 8 8 0
0 1 6 8 8 6 1 0
0 1 6 0 0 6 1 0
0 6 6 1 1 6 6 0
0 0 0 0 0 0 0 0
0 0 0 0 0 0 0 0
