MAP 50
MOVES 16
SCORE 23000
GOAL_BLOCK 
GOAL_BISCUIT 0
GOAL_DOWN 0
GOAL_OBSTACLE 6
GOAL_CREAM 9
7 6 18 18 10 18 6 7
7 7 6 6 6 6 7 7
7 8 1 7 8 1 7 8
8 7 1 8 7 1 8 7
7 8 1 7 8 1 7 8
7 7 1 7 7 1 7 7
7 7 7 7 7 7 7 7
7 7 7 7 7 7 7 7
