MAP 53
MOVES 18
SCORE 23000
GOAL_BLOCK 
GOAL_BISCUIT 18
GOAL_DOWN 0
GOAL_OBSTACLE 0
GOAL_CREAM 6
0 0 0 0 0 0 0 0
0 8 8 2 2 1 0 0
0 8 3 4 1 1 1 0
0 2 4 3 4 1 2 0
0 2 1 4 3 4 2 0
0 1 1 1 4 3 8 0
0 0 1 2 2 8 8 0
0 0 0 0 0 0 0 0 