MAP 55
MOVES 18
SCORE 23000
GOAL_BLOCK 0 20 / 2 20
GOAL_BISCUIT 16
GOAL_DOWN 0
GOAL_OBSTACLE 0
GOAL_CREAM 8
0 0 0 2 2 0 0 0
0 0 8 2 2 8 0 0
0 8 0 1 1 0 8 0
3 3 1 1 1 1 3 3
3 3 1 1 1 1 3 3
0 8 0 1 1 0 8 0
0 0 8 4 4 8 0 0
0 0 0 4 4 0 0 0 