MAP 57
MOVES 18
SCORE 23000
GOAL_BLOCK 
GOAL_BISCUIT 32
GOAL_DOWN 0
GOAL_OBSTACLE 0
GOAL_CREAM 0
0 0 0 0 0 0 0 0
0 0 0 0 0 0 0 0
0 0 0 0 0 0 0 0
3 3 3 3 3 3 3 3
4 4 4 4 4 4 3 3
2 2 2 2 4 4 4 3
1 1 1 2 2 2 4 4
1 1 1 1 1 2 2 2 