MAP 58
MOVES 15
SCORE 23000
GOAL_BLOCK 
GOAL_BISCUIT 0
GOAL_DOWN 0
GOAL_OBSTACLE 0
GOAL_CREAM 11
0 0 0 0 0 0 0 0
8 8 0 0 0 0 0 0
0 0 0 0 0 8 8 0
0 0 8 8 0 0 0 0
0 0 0 0 0 0 0 1
0 0 0 0 8 8 1 1
8 8 0 0 0 1 1 1
22 8 0 0 1 1 1 1 