MAP 8
MOVES 16
SCORE 20000
GOAL_BLOCK 
GOAL_BISCUIT 16
GOAL_DOWN 0
GOAL_OBSTACLE 16
GOAL_CREAM 4
0 0 0 1 1 13 15 12
11 0 11 6 6 10 11 10
0 11 41 6 6 41 10 15
1 6 6 7 7 6 6 1
1 6 6 7 7 6 6 1
2 2 41 6 6 41 2 2
2 2 2 6 6 2 2 2
2 2 2 1 1 2 2 2
