MAP 60
MOVES 16
SCORE 23000
GOAL_BLOCK 
GOAL_BISCUIT 36
GOAL_DOWN 0
GOAL_OBSTACLE 0
GOAL_CREAM 0
1 1 3 3 3 0 0 0
1 0 2 2 2 0 0 0
0 0 4 2 4 3 3 3
0 0 4 4 4 2 2 2
3 3 3 0 0 4 2 4
2 2 2 0 0 4 4 4
4 2 4 0 0 0 0 1
4 4 4 0 0 0 1 1 