MAP 61
MOVES 18
SCORE 23000
GOAL_BLOCK 6 25 / 7 25
GOAL_BISCUIT 0
GOAL_DOWN 0
GOAL_OBSTACLE 4
GOAL_CREAM 4
0 0 0 0 0 0 0 0
0 0 0 0 0 0 0 0
0 0 6 0 0 0 0 0
0 6 22 6 0 0 0 0
0 0 6 0 0 8 0 0
0 0 0 0 8 22 8 0
1 0 0 0 0 8 0 1
1 1 0 0 0 0 1 1
