MAP 62
MOVES 16
SCORE 23000
GOAL_BLOCK 
GOAL_BISCUIT 20
GOAL_DOWN 0
GOAL_OBSTACLE 0
GOAL_CREAM 8
1 0 0 0 0 0 0 1
1 0 0 0 0 0 0 1
1 0 3 3 3 3 0 1
0 0 3 3 3 3 0 0
8 8 2 2 2 2 8 8
4 4 8 0 0 8 4 4
1 4 4 8 8 4 4 1
1 1 7 7 7 7 1 1
