MAP 64
MOVES 16
SCORE 23000
GOAL_BLOCK 5 20 / 8 20
GOAL_BISCUIT 0
GOAL_DOWN 0
GOAL_OBSTACLE 10
GOAL_CREAM 0
0 0 0 0 0 0 0 0
0 0 0 0 0 0 0 0
0 6 1 0 0 1 6 0
0 1 1 0 0 1 1 0
0 6 1 0 0 1 6 0
0 1 1 0 0 1 1 0
0 0 6 0 0 6 0 0
0 6 22 6 6 22 6 0 