MAP 67
MOVES 15
SCORE 23000
GOAL_BLOCK 0 30
GOAL_BISCUIT 0
GOAL_DOWN 0
GOAL_OBSTACLE 0
GOAL_CREAM 8
1 0 0 0 0 0 0 1
0 0 0 8 0 0 0 0
0 0 8 22 8 0 0 0
1 0 0 8 0 0 0 1
1 0 0 0 8 0 0 1
0 0 0 8 22 8 0 0
0 0 0 0 8 0 0 0
1 0 0 0 0 0 0 1
