MAP 68
MOVES 16
SCORE 23000
GOAL_BLOCK 
GOAL_BISCUIT 0
GOAL_DOWN 2
GOAL_OBSTACLE 5
GOAL_CREAM 5
0 5 0 1 1 0 5 0
0 0 0 1 1 0 0 0
0 0 0 0 0 0 0 0
0 6 0 0 0 0 8 0
6 8 6 0 0 8 6 8
0 6 0 0 0 0 8 0
0 0 0 1 1 0 0 0
0 0 0 1 1 0 0 0
