MAP 69
MOVES 16
SCORE 23000
GOAL_BLOCK 
GOAL_BISCUIT 0
GOAL_DOWN 3
GOAL_OBSTACLE 0
GOAL_CREAM 6
0 5 0 0 0 0 0 0
0 1 0 0 0 0 0 0
0 8 1 5 0 0 0 0
0 0 8 1 0 0 0 0
0 0 0 8 1 5 0 0
0 0 0 0 8 1 0 0
0 0 0 0 0 8 1 0
0 0 0 0 0 0 8 0
