MAP 70
MOVES 16
SCORE 23000
GOAL_BLOCK 
GOAL_BISCUIT 0
GOAL_DOWN 0
GOAL_OBSTACLE 14
GOAL_CREAM 0
1 0 0 1 1 0 0 1
0 0 0 0 0 0 0 0
0 0 6 0 0 6 0 0
6 6 7 6 6 7 6 6
7 7 6 7 7 6 7 7
7 6 7 6 6 7 6 7
7 7 7 7 7 7 7 7
7 7 7 7 7 7 7 7
