MAP 9
MOVES 20
SCORE 20000
GOAL_BLOCK 
GOAL_BISCUIT 0
GOAL_DOWN 2
GOAL_OBSTACLE 8
GOAL_CREAM 8
1 1 5 0 0 5 1 1
1 0 0 0 0 0 11 1
0 0 0 0 0 0 15 11
0 0 0 0 0 0 13 12
0 0 0 0 0 13 15 13
6 6 6 6 6 6 6 6
8 8 8 8 8 31 35 31
7 7 7 7 7 7 7 7
