MAP 71
MOVES 15
SCORE 23000
GOAL_BLOCK 
GOAL_BISCUIT 30
GOAL_DOWN 0
GOAL_OBSTACLE 0
GOAL_CREAM 0
1 0 0 1 1 0 0 1
0 0 0 0 0 0 0 0
0 0 0 4 4 0 0 0
1 4 4 2 2 4 4 1
1 1 4 2 2 4 1 1
1 4 4 4 4 4 4 1
1 4 2 4 4 2 4 1
1 4 2 4 4 2 4 1
