MAP 72
MOVES 15
SCORE 23000
GOAL_BLOCK 
GOAL_BISCUIT 0
GOAL_DOWN 0
GOAL_OBSTACLE 0
GOAL_CREAM 8
0 0 0 0 0 0 0 0
0 0 0 0 0 0 0 0
0 0 1 0 0 1 0 0
0 0 0 8 8 0 0 0
0 0 8 0 0 8 0 0
0 0 1 0 0 1 0 0
0 0 0 8 8 0 0 0
0 0 0 42 42 0 0 0
