MAP 73
MOVES 18
SCORE 23000
GOAL_BLOCK 
GOAL_BISCUIT 0
GOAL_DOWN 2
GOAL_OBSTACLE 10
GOAL_CREAM 0
1 1 0 5 5 0 1 1
1 1 0 6 6 0 1 1
1 0 0 0 0 0 0 1
0 0 0 6 6 0 0 0
0 0 6 0 0 6 0 0
0 0 0 0 0 0 0 0
0 0 0 6 6 0 0 0
1 1 6 0 0 6 1 1
