MAP 74
MOVES 18
SCORE 23000
GOAL_BLOCK 
GOAL_BISCUIT 24
GOAL_DOWN 0
GOAL_OBSTACLE 8
GOAL_CREAM 0
1 1 1 0 0 1 1 1
1 0 0 0 0 0 0 1
2 2 2 2 6 2 2 6
6 2 2 6 2 2 2 2
6 4 4 6 4 4 4 4
4 4 4 4 6 4 4 6
1 0 0 0 0 0 0 1
1 1 0 0 0 0 1 1
