MAP 75
MOVES 15
SCORE 23000
GOAL_BLOCK 
GOAL_BISCUIT 0
GOAL_DOWN 0
GOAL_OBSTACLE 12
GOAL_CREAM 4
1 1 0 0 0 0 1 1
0 0 0 0 0 0 0 0
0 6 0 0 0 0 6 0
6 0 6 0 0 6 0 6
0 0 0 6 6 0 0 0
0 8 6 0 0 6 8 0
0 6 8 0 0 8 6 0
1 22 0 0 0 0 22 1
