MAP 76
MOVES 18
SCORE 23000
GOAL_BLOCK 
GOAL_BISCUIT 30
GOAL_DOWN 0
GOAL_OBSTACLE 0
GOAL_CREAM 0
0 0 1 1 1 1 0 0
0 0 0 1 1 0 0 0
4 0 0 2 2 0 0 4
4 4 0 2 2 0 4 4
4 4 4 2 2 4 4 4
0 4 4 2 2 4 4 0
0 0 4 2 2 4 0 0
1 0 0 2 2 0 0 1
