MAP 77
MOVES 16
SCORE 23000
GOAL_BLOCK 0 24 / 6 24
GOAL_BISCUIT 0
GOAL_DOWN 0
GOAL_OBSTACLE 8
GOAL_CREAM 0
1 6 0 0 0 0 6 1
6 22 6 0 0 6 22 6
0 6 0 0 0 0 6 0
0 0 0 0 0 0 0 0
0 0 0 0 0 0 0 0
0 0 0 0 0 0 0 0
0 0 0 0 0 0 0 0
0 0 0 0 0 0 0 0
