MAP 0
MOVES 18
SCORE 20000
GOAL_BLOCK 2 30 / 5 30
GOAL_BISCUIT 0
GOAL_DOWN 0
GOAL_OBSTACLE 16
GOAL_CREAM 8
0 0 0 0 0 0 15 14
15 11 0 0 0 0 12 13
10 15 10 0 0 0 13 12
35 8 8 8 8 8 32 8
7 7 6 6 6 6 7 7
7 7 6 6 6 6 7 7
7 7 6 6 6 6 7 7
7 7 6 6 6 6 7 7
