MAP 81
MOVES 16
SCORE 23000
GOAL_BLOCK 0 15 / 8 15
GOAL_BISCUIT 0
GOAL_DOWN 0
GOAL_OBSTACLE 14
GOAL_CREAM 0
0 0 1 0 0 1 0 0
0 0 1 0 0 1 0 0
6 6 7 0 0 7 6 6
7 7 0 6 6 0 7 7
7 7 6 0 0 6 7 7
1 6 7 6 6 7 6 1
1 7 7 7 7 7 7 1
1 6 7 7 7 7 6 1
