MAP 83
MOVES 18
SCORE 23000
GOAL_BLOCK 0 24 / 8 24
GOAL_BISCUIT 0
GOAL_DOWN 0
GOAL_OBSTACLE 8
GOAL_CREAM 8
20 6 6 6 6 6 6 6
6 7 7 7 7 7 7 7
7 7 7 7 7 7 7 7
1 7 1 7 7 1 7 1
7 7 7 8 8 7 7 7
7 7 8 41 41 8 7 7
7 7 7 8 8 7 7 7
7 7 7 7 7 7 7 7
