MAP 85
MOVES 16
SCORE 23000
GOAL_BLOCK 6 20 / 7 20
GOAL_BISCUIT 0
GOAL_DOWN 0
GOAL_OBSTACLE 16
GOAL_CREAM 0
1 0 0 0 0 0 0 1
0 0 0 0 0 0 0 0
0 6 0 6 6 0 6 0
6 7 6 7 7 6 7 6
6 7 6 7 7 6 7 6
7 6 6 7 7 6 6 7
7 7 7 7 7 7 7 7
7 7 1 7 7 1 7 7
