MAP 89
MOVES 18
SCORE 23000
GOAL_BLOCK 
GOAL_BISCUIT 50
GOAL_DOWN 0
GOAL_OBSTACLE 6
GOAL_CREAM 2
3 3 3 3 3 3 1 1
3 3 3 3 3 3 3 1
6 6 3 3 3 3 3 3
42 6 4 4 4 4 3 3
42 6 4 4 4 4 3 3
6 6 3 3 3 3 3 3
3 3 3 3 3 3 3 1
3 3 3 3 3 3 1 1
