MAP 90
MOVES 18
SCORE 23000
GOAL_BLOCK 
GOAL_BISCUIT 36
GOAL_DOWN 0
GOAL_OBSTACLE 0
GOAL_CREAM 10
2 2 1 0 0 1 2 2
2 2 0 0 0 0 2 2
2 2 8 0 0 8 2 2
1 8 4 4 4 4 8 1
42 0 4 4 4 4 0 42
1 8 4 4 4 4 8 1
2 2 2 8 8 2 2 2
2 2 2 1 1 2 2 2 