MAP 91
MOVES 18
SCORE 23000
GOAL_BLOCK 
GOAL_BISCUIT 0
GOAL_DOWN 2
GOAL_OBSTACLE 8
GOAL_CREAM 6
1 0 0 0 0 0 0 1
0 0 5 0 0 5 0 0
8 0 6 0 0 6 0 8
1 8 6 0 0 6 8 1
0 0 8 0 0 8 0 0
0 0 6 0 0 6 0 0
1 0 6 0 0 6 0 1
1 0 0 0 0 0 0 1
