MAP 20
MOVES 18
SCORE 20000
GOAL_BLOCK 3 30 / 4 30
GOAL_BISCUIT 0
GOAL_DOWN 0
GOAL_OBSTACLE 8
GOAL_CREAM 4
1 1 1 0 0 1 1 1
1 1 0 0 0 0 1 1
1 13 0 6 6 0 0 1
13 0 6 8 8 6 0 0
0 13 6 8 8 6 0 0
1 0 0 6 6 0 0 1
1 1 0 14 0 14 1 1
1 1 1 0 14 1 1 1
