MAP 92
MOVES 18
SCORE 23000
GOAL_BLOCK 
GOAL_BISCUIT 0
GOAL_DOWN 2
GOAL_OBSTACLE 6
GOAL_CREAM 6
1 5 0 0 0 0 5 1
1 0 0 0 0 0 0 1
1 6 8 0 0 8 6 1
1 1 0 0 0 0 1 1
1 6 8 0 0 8 6 1
1 0 0 0 0 0 0 1
1 6 0 8 8 0 6 1
1 0 0 0 0 0 0 1
