MAP 93
MOVES 18
SCORE 23000
GOAL_BLOCK 
GOAL_BISCUIT 18
GOAL_DOWN 0
GOAL_OBSTACLE 10
GOAL_CREAM 0
1 1 0 0 0 2 1 1
1 0 0 0 2 2 1 1
6 6 6 2 0 0 0 0
3 3 3 6 4 6 4 0
3 3 3 6 4 6 4 0
6 6 6 2 0 0 0 0
1 0 0 0 2 2 1 1
1 1 0 0 0 2 1 1 