MAP 94
MOVES 20
SCORE 23000
GOAL_BLOCK 0 20 / 6 20
GOAL_BISCUIT 0
GOAL_DOWN 0
GOAL_OBSTACLE 8
GOAL_CREAM 8
1 0 0 0 0 0 0 1
1 0 0 0 0 0 0 1
6 6 6 0 0 6 6 6
7 7 0 0 0 0 7 0
8 7 6 1 1 6 7 8
7 7 8 7 7 8 7 7
7 7 7 8 8 7 7 7
8 7 1 1 1 1 7 8
