MAP 96
MOVES 16
SCORE 23000
GOAL_BLOCK 
GOAL_BISCUIT 0
GOAL_DOWN 0
GOAL_OBSTACLE 0
GOAL_CREAM 16
1 39 0 0 1 1 1 1
1 0 0 0 0 0 0 40
1 0 41 8 8 41 0 0
1 0 8 1 1 8 0 0
0 0 8 1 1 8 0 1
0 0 41 8 8 41 0 1
40 0 0 0 0 0 0 1
1 1 1 1 0 0 39 1 