MAP 98
MOVES 18
SCORE 23000
GOAL_BLOCK 
GOAL_BISCUIT 0
GOAL_DOWN 4
GOAL_OBSTACLE 6
GOAL_CREAM 6
5 0 0 0 0 0 0 5
0 0 0 0 0 0 0 0
6 0 0 0 0 0 0 6
6 0 5 0 0 5 0 6
0 0 8 0 0 8 0 0
6 0 0 0 0 0 0 6
0 0 0 8 8 0 0 0
1 8 0 0 0 0 8 1 