MAP 100
MOVES 18
SCORE 23000
GOAL_BLOCK 
GOAL_BISCUIT 21
GOAL_DOWN 0
GOAL_OBSTACLE 10
GOAL_CREAM 0
0 0 0 0 0 0 0 1
0 2 2 6 0 0 0 0
0 2 2 6 0 0 0 0
0 6 6 2 0 2 2 2
0 0 0 0 2 6 6 6
0 0 0 2 6 3 3 3
0 0 0 2 6 3 4 4
1 0 0 2 6 3 4 4
