MAP 102
MOVES 16
SCORE 23000
GOAL_BLOCK 7 20 / 8 20
GOAL_BISCUIT 32
GOAL_DOWN 0
GOAL_OBSTACLE 0
GOAL_CREAM 0
0 0 0 0 1 0 0 0
0 3 3 3 3 2 2 0
0 3 3 3 3 2 2 0
1 2 2 1 1 2 2 0
0 2 2 1 1 2 2 1
0 2 2 4 4 4 4 0
0 2 2 4 4 4 4 0
0 0 0 1 0 0 0 0 