MAP 103
MOVES 16
SCORE 23000
GOAL_BLOCK 2 20 / 6 20
GOAL_BISCUIT 0
GOAL_DOWN 0
GOAL_OBSTACLE 0
GOAL_CREAM 5
0 0 0 0 0 0 0 0
0 0 0 0 0 0 0 0
0 0 0 0 0 1 1 1
0 0 0 0 0 0 0 0
0 0 0 0 0 0 0 0
1 1 1 7 7 7 8 8
7 7 7 7 7 8 7 7
7 7 7 7 7 8 7 42
