MAP 13
MOVES 18
SCORE 23000
GOAL_BLOCK 0 30 / 2 30
GOAL_BISCUIT 0
GOAL_DOWN 0
GOAL_OBSTACLE 10
GOAL_CREAM 0
1 0 0 0 0 0 0 1
0 0 0 0 0 0 0 0
0 0 6 0 0 6 0 0
0 6 0 0 0 0 6 0
6 0 0 6 6 0 0 6
0 0 0 0 0 0 0 0
0 0 6 0 0 6 0 0
1 0 0 0 0 0 0 1
