MAP 19
MOVES 20
SCORE 22000
GOAL_BLOCK 1 24 / 2 24
GOAL_BISCUIT 0
GOAL_DOWN 4
GOAL_OBSTACLE 0
GOAL_CREAM 8
0 5 0 5 5 0 5 0
0 0 0 0 0 0 0 0
1 0 0 0 0 0 0 1
0 8 0 8 8 0 8 0
0 8 0 8 8 0 8 0
1 0 0 0 0 0 0 1
0 0 0 0 0 0 0 0
0 0 0 0 0 0 0 0
