MAP 104
MOVES 16
SCORE 23000
GOAL_BLOCK 
GOAL_BISCUIT 20
GOAL_DOWN 0
GOAL_OBSTACLE 6
GOAL_CREAM 0
0 0 0 1 1 1 0 0
0 0 0 6 1 1 0 0
0 0 0 2 6 1 0 0
0 0 2 2 2 6 0 0
0 0 6 2 2 2 0 0
4 4 1 6 2 0 0 0
4 4 1 1 6 4 4 4
4 4 1 1 1 4 4 4
