MAP 105
MOVES 16
SCORE 23000
GOAL_BLOCK 
GOAL_BISCUIT 26
GOAL_DOWN 0
GOAL_OBSTACLE 6
GOAL_CREAM 0
1 0 0 0 0 0 0 1
0 0 0 0 0 0 0 0
0 1 4 4 4 4 1 0
0 2 4 4 4 4 2 0
0 2 6 6 6 6 2 0
0 1 6 3 3 6 1 0
0 2 2 3 3 2 2 0
1 2 2 2 2 2 2 1
