MAP 106
MOVES 16
SCORE 23000
GOAL_BLOCK 0 25 / 6 25
GOAL_BISCUIT 0
GOAL_DOWN 0
GOAL_OBSTACLE 16
GOAL_CREAM 0
1 1 0 0 0 0 1 1
1 0 6 0 0 6 0 1
0 0 6 0 0 6 0 0
0 6 0 0 0 0 6 0
6 0 0 6 6 0 0 6
0 0 1 1 1 1 0 0
0 0 0 1 1 0 0 0
6 6 6 1 1 6 6 6
