MAP 108
MOVES 16
SCORE 23000
GOAL_BLOCK 
GOAL_BISCUIT 22
GOAL_DOWN 0
GOAL_OBSTACLE 0
GOAL_CREAM 10
1 1 0 0 0 0 1 1
1 1 0 0 0 0 1 1
1 1 8 0 0 8 1 1
2 8 2 8 8 2 8 2
2 2 2 4 4 2 2 2
2 2 8 4 4 8 2 2
1 1 2 4 4 2 1 1
1 1 1 8 8 1 1 1
