MAP 109
MOVES 18
SCORE 23000
GOAL_BLOCK 2 20 / 7 20
GOAL_BISCUIT 0
GOAL_DOWN 0
GOAL_OBSTACLE 0
GOAL_CREAM 8
0 0 0 0 0 0 0 0
0 0 0 8 8 0 0 0
0 0 0 0 0 0 0 0
1 0 0 8 8 0 0 1
1 1 0 0 0 0 1 1
1 0 0 8 8 0 0 1
0 0 0 0 0 0 0 0
0 0 0 8 8 0 0 0
