MAP 4
MOVES 14
SCORE 23000
GOAL_BLOCK 
GOAL_BISCUIT 32
GOAL_DOWN 0
GOAL_OBSTACLE 0
GOAL_CREAM 6
1 1 0 0 0 0 1 1
1 1 0 0 0 0 1 1
8 0 8 2 2 8 0 8
2 2 2 8 8 2 2 2
2 4 4 3 3 4 4 2
2 4 4 3 3 4 4 2
1 1 4 3 3 4 1 1
1 1 4 3 3 4 1 1 