MAP 8
MOVES 16
SCORE 23000
GOAL_BLOCK 
GOAL_BISCUIT 0
GOAL_DOWN 0
GOAL_OBSTACLE 8
GOAL_CREAM 8
7 7 7 1 1 7 7 7
7 7 8 7 7 8 7 7
7 8 7 7 7 7 8 7
1 7 6 7 7 6 7 1
1 6 21 6 6 21 6 1
7 8 6 7 7 6 8 7
7 7 8 7 7 8 7 7
7 7 7 1 1 7 7 7
