MAP 9
MOVES 16
SCORE 23000
GOAL_BLOCK 
GOAL_BISCUIT 28
GOAL_DOWN 0
GOAL_OBSTACLE 0
GOAL_CREAM 8
1 1 0 0 0 0 1 1
1 0 0 0 0 0 0 1
0 2 2 2 2 2 2 0
0 3 3 3 3 3 3 0
0 3 3 3 3 3 3 0
0 2 8 2 2 8 2 0
0 8 42 8 8 42 8 0
0 2 2 2 2 2 2 0
