MAP 10
MOVES 18
SCORE 22000
GOAL_BLOCK 4 30 / 5 30
GOAL_BISCUIT 0
GOAL_DOWN 0
GOAL_OBSTACLE 0
GOAL_CREAM 16
1 0 0 1 1 0 0 1
0 0 0 1 1 0 0 0
0 0 15 1 1 14 0 0
8 35 8 8 8 8 34 8
8 35 8 8 8 8 34 8
7 7 7 7 7 7 7 7
7 7 7 7 7 7 7 7
7 7 7 7 7 7 7 7 