MAP 13
MOVES 16
SCORE 23000
GOAL_BLOCK 5 21 / 6 21
GOAL_BISCUIT 24
GOAL_DOWN 0
GOAL_OBSTACLE 0
GOAL_CREAM 0
1 0 0 0 0 0 0 1
0 0 0 0 0 0 0 0
3 3 3 0 0 3 3 3
3 3 3 4 4 3 3 3
0 3 3 4 4 3 3 0
0 0 4 4 4 4 0 0
0 0 0 0 0 0 0 0
1 0 0 0 0 0 0 1
