MAP 0
MOVES 16
SCORE 23000
GOAL_BLOCK 8 30
GOAL_BISCUIT 0
GOAL_DOWN 0
GOAL_OBSTACLE 20
GOAL_CREAM 0
12 18 6 6 6 6 6 6
18 16 6 7 7 6 7 7
0 18 6 7 7 6 7 7
0 0 6 7 7 6 7 7
0 0 6 7 7 6 7 7
0 0 6 7 7 6 7 7
0 0 6 7 7 6 7 7
0 0 6 7 7 6 7 7 