MAP 19
MOVES 16
SCORE 23000
GOAL_BLOCK 
GOAL_BISCUIT 32
GOAL_DOWN 0
GOAL_OBSTACLE 0
GOAL_CREAM 0
0 0 0 0 0 0 0 0
0 0 0 0 0 0 0 0
1 0 3 3 3 3 0 1
2 2 0 3 3 0 2 2
2 2 0 4 4 0 2 2
1 0 4 4 4 4 0 1
2 2 4 4 4 4 2 2
2 2 0 0 0 0 2 2 