MAP 20
MOVES 15
SCORE 23000
GOAL_BLOCK 0 20 / 2 20
GOAL_BISCUIT 24
GOAL_DOWN 0
GOAL_OBSTACLE 0
GOAL_CREAM 0
1 1 1 0 0 1 1 1
1 1 0 2 2 0 1 1
1 0 4 3 3 4 0 1
0 2 3 4 4 3 2 0
0 2 3 4 4 3 2 0
1 0 4 3 3 4 0 1
1 1 0 2 2 0 1 1
1 1 1 0 0 1 1 1 