MAP 23
MOVES 16
SCORE 23000
GOAL_BLOCK 
GOAL_BISCUIT 0
GOAL_DOWN 0
GOAL_OBSTACLE 0
GOAL_CREAM 14
0 0 1 0 0 1 0 0
0 0 1 0 0 1 0 0
0 0 0 0 0 0 0 0
8 8 0 0 0 0 8 8
7 7 8 0 0 8 7 7
1 1 7 41 41 7 1 1
7 7 8 7 7 8 7 7
8 8 7 7 7 7 8 8 