MAP 28
MOVES 15
SCORE 23000
GOAL_BLOCK 
GOAL_BISCUIT 0
GOAL_DOWN 4
GOAL_OBSTACLE 0
GOAL_CREAM 10
1 1 0 5 5 0 1 1
0 5 0 0 0 0 5 0
8 0 8 0 0 8 0 8
0 8 0 0 0 0 8 0
0 0 0 0 0 0 0 0
0 8 0 0 0 0 8 0
0 0 0 8 8 0 0 0
1 1 0 0 0 0 1 1
