MAP 30
MOVES 18
SCORE 23000
GOAL_BLOCK 
GOAL_BISCUIT 22
GOAL_DOWN 0
GOAL_OBSTACLE 8
GOAL_CREAM 8
0 0 0 1 1 0 0 0
0 0 0 1 1 0 0 0
1 8 0 0 0 0 8 1
3 3 8 0 0 8 3 3
6 3 3 8 8 3 3 6
3 6 3 1 1 3 6 3
6 3 3 3 3 3 3 6
3 6 3 41 42 3 6 3 