MAP 32
MOVES 15
SCORE 23000
GOAL_BLOCK 6 25 / 7 25
GOAL_BISCUIT 0
GOAL_DOWN 0
GOAL_OBSTACLE 0
GOAL_CREAM 8
0 0 0 0 0 0 1 1
0 0 0 0 0 0 1 1
0 0 0 0 0 0 0 1
0 0 0 0 8 8 8 8
8 8 8 8 7 7 7 7
1 7 7 7 7 7 7 7
1 1 7 7 7 7 7 7
1 1 7 7 7 7 7 7
