MAP 46
MOVES 15
SCORE 23000
GOAL_BLOCK 2 25 / 8 25
GOAL_BISCUIT 0
GOAL_DOWN 0
GOAL_OBSTACLE 12
GOAL_CREAM 4
0 0 0 1 1 0 0 0
0 0 0 0 0 0 0 0
0 0 0 0 6 0 6 0
1 6 0 6 0 41 0 1
1 0 41 0 6 0 6 1
1 6 0 6 0 41 0 1
1 0 41 0 6 0 6 1
1 6 0 6 0 0 0 1
