MAP 62
MOVES 15
SCORE 23000
GOAL_BLOCK 
GOAL_BISCUIT 28
GOAL_DOWN 0
GOAL_OBSTACLE 0
GOAL_CREAM 0
1 0 0 2 2 0 0 1
1 0 0 2 2 0 0 1
1 0 4 3 3 4 0 1
0 4 3 3 3 3 4 0
3 0 4 3 3 4 0 3
0 0 4 3 3 4 0 0
1 0 0 4 4 0 0 1
1 1 0 4 4 0 1 1
