MAP 5
MOVES 21
SCORE 24000
GOAL_BLOCK 
GOAL_BISCUIT 24
GOAL_DOWN 0
GOAL_OBSTACLE 0
GOAL_CREAM 8
1 0 0 1 1 0 0 1
1 0 0 1 1 0 0 1
2 2 2 2 2 2 2 2
2 2 2 2 2 2 2 2
2 2 8 8 8 8 2 2
2 2 8 8 8 8 2 2
1 1 7 7 7 7 1 1
1 1 7 7 7 7 1 1
