MAP 71
MOVES 16
SCORE 23000
GOAL_BLOCK 6 21 / 8 21
GOAL_BISCUIT 0
GOAL_DOWN 0
GOAL_OBSTACLE 0
GOAL_CREAM 10
1 0 0 1 1 0 0 1
0 0 0 0 0 0 0 0
0 0 0 0 0 0 0 0
1 8 0 0 0 0 8 1
1 1 0 0 0 0 1 1
1 8 0 0 0 0 8 1
1 41 8 0 0 8 41 1
1 8 0 0 0 0 8 1
