MAP 111
MOVES 14
SCORE 23000
GOAL_BLOCK 6 21 / 8 21
GOAL_BISCUIT 0
GOAL_DOWN 0
GOAL_OBSTACLE 10
GOAL_CREAM 2
1 0 0 0 0 0 0 1
0 0 1 0 0 1 0 0
0 1 1 0 0 1 1 0
0 6 6 0 0 6 6 0
0 0 0 1 1 0 0 0
0 0 6 0 0 6 0 0
0 1 0 6 6 0 1 0
0 0 6 42 41 6 0 0
