MAP 112
MOVES 17
SCORE 23000
GOAL_BLOCK 
GOAL_BISCUIT 0
GOAL_DOWN 0
GOAL_OBSTACLE 18
GOAL_CREAM 3
0 0 0 0 17 18 12 18
0 40 1 0 18 12 16 12
6 1 1 6 6 6 6 6
7 7 7 41 1 7 7 7
6 6 6 1 1 6 6 6
7 7 7 7 7 40 1 7
6 6 6 6 6 1 1 6
7 7 7 7 7 7 7 7 