MAP 0
MOVES 15
SCORE 23000
GOAL_BLOCK 
GOAL_BISCUIT 54
GOAL_DOWN 0
GOAL_OBSTACLE 0
GOAL_CREAM 8
4 4 4 4 4 4 4 4
4 4 4 4 4 4 4 4
4 4 4 37 38 4 4 4
4 4 4 37 38 4 4 4
4 4 4 18 17 4 4 4
4 4 4 37 38 4 4 4
4 4 4 37 38 4 4 4
4 4 4 4 4 4 4 4
