MAP 90
MOVES 16
SCORE 23000
GOAL_BLOCK 5 15 / 7 15
GOAL_BISCUIT 32
GOAL_DOWN 0
GOAL_OBSTACLE 0
GOAL_CREAM 0
0 0 1 0 0 1 0 0
0 0 2 2 2 2 0 0
0 2 3 4 4 3 2 0
1 2 4 4 4 4 2 1
0 2 4 3 3 4 2 0
1 2 3 3 3 3 2 1
0 0 2 2 2 2 0 0
0 0 0 1 1 0 0 0
