MAP 113
MOVES 15
SCORE 23000
GOAL_BLOCK 7 30
GOAL_BISCUIT 0
GOAL_DOWN 0
GOAL_OBSTACLE 18
GOAL_CREAM 7
1 17 12 17 18 10 16 1
12 16 12 18 17 15 15 12
6 6 15 37 16 18 6 6
7 6 6 37 37 6 6 7
6 7 6 6 6 6 7 6
7 6 7 8 8 7 6 7
1 7 6 7 7 6 7 1
1 1 7 8 8 7 1 0
