MAP 0
MOVES 15
SCORE 23000
GOAL_BLOCK 0 20 / 6 20
GOAL_BISCUIT 0
GOAL_DOWN 0
GOAL_OBSTACLE 20
GOAL_CREAM 4
0 0 0 0 0 0 0 18
0 6 6 6 6 6 6 18
0 6 7 7 7 7 6 10
0 6 7 41 41 7 6 12
0 6 7 41 41 7 6 10
0 6 7 7 7 7 6 10
0 6 6 6 6 6 6 12
0 0 0 0 0 0 0 16
