MAP 38
MOVES 16
SCORE 23000
GOAL_BLOCK 
GOAL_BISCUIT 12
GOAL_DOWN 2
GOAL_OBSTACLE 0
GOAL_CREAM 6
0 0 1 5 5 1 0 0
0 0 1 0 0 1 0 0
0 0 1 1 1 1 0 0
0 0 0 8 8 0 0 0
0 0 8 0 0 8 0 0
0 4 4 8 8 4 4 0
0 4 4 4 4 4 4 0
0 4 1 1 1 1 4 0 