MAP 4
MOVES 16
SCORE 8000
GOAL_BLOCK 0 15 / 1 15 / 2 15
GOAL_BISCUIT 0
GOAL_DOWN 0
GOAL_OBSTACLE 0
GOAL_CREAM 0
1 1 0 0 0 0 1 1
1 1 0 0 0 0 1 1
0 0 0 0 0 0 0 0
0 0 12 13 10 11 12 0
0 11 10 10 12 10 10 11
0 0 13 11 12 12 13 0
1 1 0 0 0 0 1 1
1 1 0 0 0 0 1 1
