MAP 11
MOVES 18
SCORE 17000
GOAL_BLOCK 
GOAL_BISCUIT 0
GOAL_DOWN 2
GOAL_OBSTACLE 8
GOAL_CREAM 8
1 0 5 1 1 5 0 1
0 0 0 0 0 0 0 0
0 0 0 0 0 0 0 0
0 15 0 0 0 0 10 0
35 6 6 8 8 6 6 30
35 6 6 8 8 6 6 30
7 7 7 7 7 7 7 7
7 1 1 7 7 1 1 7
