MAP 53
MOVES 14
SCORE 23000
GOAL_BLOCK 
GOAL_BISCUIT 22
GOAL_DOWN 0
GOAL_OBSTACLE 0
GOAL_CREAM 4
0 0 0 0 0 0 0 0
0 2 2 2 2 1 2 0
0 2 2 2 1 1 1 0
0 2 2 41 8 1 2 0
0 2 1 8 41 2 2 0
0 1 1 1 2 2 2 0
0 2 1 2 2 2 2 0
0 0 0 0 0 0 0 0
