MAP 21
MOVES 20
SCORE 18000
GOAL_BLOCK 
GOAL_BISCUIT 26
GOAL_DOWN 0
GOAL_OBSTACLE 0
GOAL_CREAM 0
1 1 0 0 0 0 1 1
1 0 0 0 0 0 0 1
0 0 0 0 0 0 0 0
0 0 0 0 0 0 0 0
3 3 3 3 3 3 3 3
3 3 3 3 3 3 3 3
1 3 3 3 3 3 3 1
1 1 3 3 3 3 1 1 