MAP 17
MOVES 21
SCORE 16000
GOAL_BLOCK 
GOAL_BISCUIT 10
GOAL_DOWN 0
GOAL_OBSTACLE 12
GOAL_CREAM 0
1 0 0 0 0 0 0 1
1 0 0 0 0 0 0 1
1 0 0 0 0 0 0 1
1 0 0 0 0 0 0 1
1 6 6 6 6 6 6 1
1 6 6 6 6 6 6 1
1 3 3 3 3 3 3 1
1 3 1 3 3 1 3 1
