MAP 23
MOVES 17
SCORE 16000
GOAL_BLOCK 
GOAL_BISCUIT 12
GOAL_DOWN 0
GOAL_OBSTACLE 8
GOAL_CREAM 8
0 0 0 0 0 0 0 0
0 0 0 0 0 0 0 0
10 13 0 0 0 0 0 10
33 6 6 8 8 6 6 34
33 6 6 8 8 6 6 34
10 0 0 0 0 0 0 10
3 3 0 3 3 0 3 3
3 3 0 3 3 0 3 3
