MAP 23
MOVES 17
SCORE 17000
GOAL_BLOCK 0 26 / 5 26
GOAL_BISCUIT 24
GOAL_DOWN 0
GOAL_OBSTACLE 0
GOAL_CREAM 4
0 0 1 0 0 1 0 0
0 0 1 0 0 1 0 0
0 0 0 0 0 0 0 0
0 0 3 3 3 3 0 0
0 0 3 3 3 3 0 0
1 1 8 8 8 8 1 1
2 2 3 3 3 3 2 2
2 2 3 3 3 3 2 2 