MAP 8
MOVES 18
SCORE 15000
GOAL_BLOCK 0 26 / 5 26
GOAL_BISCUIT 18
GOAL_DOWN 0
GOAL_OBSTACLE 10
GOAL_CREAM 0
0 0 0 1 1 0 0 0
0 0 0 0 0 0 0 0
0 0 0 0 0 0 0 0
1 0 0 0 0 0 0 1
1 6 6 6 6 6 6 1
3 3 3 6 6 3 3 3
3 3 3 6 6 3 3 3
3 3 3 1 1 3 3 3 