MAP 0
MOVES 22
SCORE 19000
GOAL_BLOCK 
GOAL_BISCUIT 24
GOAL_DOWN 0
GOAL_OBSTACLE 0
GOAL_CREAM 8
0 0 2 2 2 2 0 0
0 0 2 2 2 2 0 0
0 0 8 8 8 8 0 0
0 0 3 3 3 3 0 0
0 0 3 3 3 3 0 0
0 0 8 8 8 8 0 0
0 0 2 2 2 2 0 0
0 0 2 2 2 2 0 0
