MAP 16
MOVES 21
SCORE 19000
GOAL_BLOCK 
GOAL_BISCUIT 12
GOAL_DOWN 2
GOAL_OBSTACLE 0
GOAL_CREAM 4
1 1 1 0 0 1 1 1
1 1 5 0 0 5 1 1
1 0 3 3 3 3 0 1
0 0 8 3 3 8 0 0
1 0 8 3 3 8 0 1
0 0 3 3 3 3 0 0
1 1 1 0 0 1 1 1
1 1 0 0 0 0 1 1
