MAP 0
MOVES 22
SCORE 19000
GOAL_BLOCK 0 30 / 3 30 / 5 30
GOAL_BISCUIT 32
GOAL_DOWN 0
GOAL_OBSTACLE 0
GOAL_CREAM 0
0 0 3 0 0 3 0 0
0 0 3 0 0 3 0 0
3 3 3 3 3 3 3 3
0 0 3 3 3 3 0 0
0 0 3 3 3 3 0 0
3 3 3 3 3 3 3 3
0 0 3 0 0 3 0 0
0 0 3 0 0 3 0 0
