MAP 4
MOVES 21
SCORE 19000
GOAL_BLOCK 
GOAL_BISCUIT 20
GOAL_DOWN 0
GOAL_OBSTACLE 8
GOAL_CREAM 4
1 1 0 0 0 0 1 1
1 1 0 0 0 0 1 1
0 0 8 6 6 8 0 0
3 3 6 2 2 6 3 3
3 3 6 2 2 6 3 3
0 0 8 6 6 8 0 0
1 1 3 3 3 3 1 1
1 1 3 3 3 3 1 1 