dMAP 15
MOVES 20
SCORE 19000
GOAL_BLOCK 1 30 / 3 30
GOAL_BISCUIT 24
GOAL_DOWN 0
GOAL_OBSTACLE 6
GOAL_CREAM 0
0 0 0 1 1 0 0 0
0 0 0 1 1 0 0 0
0 0 0 1 1 0 0 0
1 1 1 1 1 1 1 1
2 2 2 2 2 2 2 2
2 3 2 6 6 2 3 2
3 21 3 6 6 3 21 3
2 3 2 6 6 2 3 2 