MAP 24
MOVES 19
SCORE 17500
GOAL_BLOCK 
GOAL_BISCUIT 16
GOAL_DOWN 0
GOAL_OBSTACLE 8
GOAL_CREAM 0
0 0 0 0 0 0 0 0
0 0 0 0 0 0 0 0
0 1 0 1 1 0 1 0
0 2 6 3 3 6 2 0
0 2 6 3 3 6 2 0
0 1 0 1 1 0 1 0
0 2 6 3 3 6 2 0
0 2 6 3 3 6 2 0
