MAP 25
MOVES 20
SCORE 21000
GOAL_BLOCK 4 27 / 5 27
GOAL_BISCUIT 16
GOAL_DOWN 0
GOAL_OBSTACLE 0
GOAL_CREAM 4
1 1 1 0 0 1 1 1
0 1 0 0 0 0 1 0
0 0 0 0 0 0 0 0
0 0 0 8 8 0 0 0
0 0 0 8 8 0 0 0
3 3 3 0 0 3 3 3
3 3 3 0 0 3 3 3
1 3 3 0 0 3 3 1
