MAP 26
MOVES 20
SCORE 17500
GOAL_BLOCK 
GOAL_BISCUIT 22
GOAL_DOWN 2
GOAL_OBSTACLE 2
GOAL_CREAM 4
0 0 1 5 5 1 0 0
0 0 0 0 0 0 0 0
0 0 1 2 2 1 0 0
3 3 0 8 8 0 3 3
3 3 1 2 2 1 3 3
0 0 0 6 6 0 0 0
3 3 1 2 2 1 3 3
3 3 0 8 8 0 3 3
