MAP 13
MOVES 18
SCORE 22000
GOAL_BLOCK 1 25 / 3 25
GOAL_BISCUIT 0
GOAL_DOWN 0
GOAL_OBSTACLE 12
GOAL_CREAM 8
1 0 0 0 0 0 0 1
0 0 0 0 0 0 0 0
0 0 0 8 8 0 0 0
0 0 8 20 21 8 0 0
0 6 8 0 0 8 6 0
0 6 6 8 8 6 6 0
0 6 6 6 6 6 6 0
1 0 0 0 0 0 0 1
