MAP 19
MOVES 18
SCORE 23000
GOAL_BLOCK 4 30 / 5 30 / 6 30
GOAL_BISCUIT 42
GOAL_DOWN 0
GOAL_OBSTACLE 0
GOAL_CREAM 0
0 0 0 0 0 0 0 0
0 0 0 0 0 0 0 0
1 3 3 22 22 3 3 1
3 3 3 3 3 3 3 3
3 3 3 3 3 3 3 3
1 3 3 3 3 3 3 1
3 3 3 3 3 3 3 3
3 3 3 3 3 3 3 3
