kMAP 27
MOVES 22
SCORE 23000
GOAL_BLOCK 6 40
GOAL_BISCUIT 32
GOAL_DOWN 0
GOAL_OBSTACLE 0
GOAL_CREAM 10
1 1 1 2 2 1 1 1
1 1 2 2 2 2 1 1
1 2 2 2 2 2 2 1
3 3 8 8 8 8 3 3
3 3 8 22 22 8 3 3
3 3 8 8 8 8 3 3
1 1 3 3 3 3 1 1
1 1 3 3 3 3 1 1
