MAP 0
MOVES 18
SCORE 21000
GOAL_BLOCK 5 30 / 6 30
GOAL_BISCUIT 24
GOAL_DOWN 0
GOAL_OBSTACLE 15
GOAL_CREAM 0
15 16 15 16 6 2 2 2
16 15 16 15 6 2 2 2
15 16 15 16 6 2 2 2
16 15 16 15 6 2 2 2
6 6 6 6 6 6 6 6
3 3 3 3 6 7 7 7
3 3 3 3 6 7 7 7
3 3 3 3 6 7 7 7
