MAP 14
MOVES 20
SCORE 23000
GOAL_BLOCK 5 35
GOAL_BISCUIT 9
GOAL_DOWN 0
GOAL_OBSTACLE 0
GOAL_CREAM 21
7 1 7 1 1 7 1 7
21 20 19 19 19 19 19 19
19 7 7 7 7 7 7 7
20 7 8 8 8 8 8 8
20 7 8 8 8 8 8 8
20 7 8 8 8 3 3 3
20 7 8 8 8 3 3 3
20 7 8 8 8 3 3 3
