MAP 18
MOVES 16
SCORE 24000
GOAL_BLOCK 
GOAL_BISCUIT 36
GOAL_DOWN 0
GOAL_OBSTACLE 12
GOAL_CREAM 0
1 2 2 2 1 1 1 1
1 2 2 2 6 2 2 2
1 2 2 2 6 2 2 2
1 6 6 6 6 2 2 2
3 3 3 6 6 6 6 1
3 3 3 6 3 3 3 1
3 3 3 6 3 3 3 1
1 1 1 1 3 3 3 1 