MAP 8
MOVES 18
SCORE 24000
GOAL_BLOCK 2 30 / 3 30
GOAL_BISCUIT 0
GOAL_DOWN 0
GOAL_OBSTACLE 8
GOAL_CREAM 2
0 0 0 1 1 0 0 0
0 0 0 0 0 0 0 0
0 0 0 0 0 0 0 0
1 0 0 8 8 0 0 1
1 6 6 21 21 6 6 1
7 7 7 6 6 7 7 7
7 7 7 6 6 7 7 7
7 7 7 1 1 7 7 7
