MAP 21
MOVES 18
SCORE 26000
GOAL_BLOCK 
GOAL_BISCUIT 16
GOAL_DOWN 2
GOAL_OBSTACLE 0
GOAL_CREAM 6
1 1 0 0 0 0 1 1
1 5 0 0 0 0 5 1
0 0 0 0 0 0 0 0
0 0 0 0 0 0 0 0
0 8 2 8 8 2 8 0
0 8 3 3 3 3 8 0
1 2 3 3 3 3 2 1
1 1 3 3 3 3 1 1
