MAP 13
MOVES 20
SCORE 26000
GOAL_BLOCK 1 30 / 2 30
GOAL_BISCUIT 22
GOAL_DOWN 0
GOAL_OBSTACLE 0
GOAL_CREAM 10
1 2 2 0 0 2 2 1
2 2 2 0 0 2 2 2
2 2 2 0 0 2 2 2
0 0 0 0 0 0 0 0
0 0 0 0 0 0 0 0
8 8 8 3 3 8 8 8
7 7 8 3 3 8 7 7
1 7 8 3 3 8 7 1
