MAP 10
MOVES 18
SCORE 28000
GOAL_BLOCK 4 35 / 5 35
GOAL_BISCUIT 0
GOAL_DOWN 0
GOAL_OBSTACLE 14
GOAL_CREAM 18
1 0 0 1 1 0 0 1
0 0 0 1 1 0 0 0
0 0 0 1 1 0 0 0
19 19 19 20 20 19 19 19
6 6 6 6 6 6 6 6
8 8 8 6 6 8 8 8
8 8 8 6 6 8 8 8
8 8 8 6 6 8 8 8 