MAP 28
MOVES 16
SCORE 28000
GOAL_BLOCK 
GOAL_BISCUIT 56
GOAL_DOWN 0
GOAL_OBSTACLE 0
GOAL_CREAM 0
1 1 2 2 2 2 1 1
2 2 2 2 2 2 2 2
2 2 2 2 2 2 2 2
2 2 2 2 2 2 2 2
3 3 3 3 3 3 3 3
3 3 3 3 3 3 3 3
3 3 3 3 3 3 3 3
1 1 3 3 3 3 1 1
