MAP 29
MOVES 20
SCORE 29000
GOAL_BLOCK 6 35
GOAL_BISCUIT 0
GOAL_DOWN 0
GOAL_OBSTACLE 4
GOAL_CREAM 8
1 14 13 12 16 11 12 1
1 14 16 16 13 16 11 1
1 1 6 6 6 6 1 1
1 7 7 7 7 7 7 1
1 8 8 7 7 8 8 1
7 7 7 8 8 7 7 7
7 7 7 8 8 7 7 7
7 7 7 1 1 7 7 7
