MAP 24
MOVES 20
SCORE 29000
GOAL_BLOCK 5 35 / 6 35
GOAL_BISCUIT 0
GOAL_DOWN 0
GOAL_OBSTACLE 16
GOAL_CREAM 0
14 13 15 11 12 16 16 15
13 15 12 12 11 12 16 15
6 1 6 1 1 6 1 6
7 6 7 6 6 7 6 7
7 7 7 7 7 7 7 7
6 1 6 1 1 6 1 6
7 6 7 6 6 7 6 7
7 7 7 7 7 7 7 7
