MAP 6
MOVES 18
SCORE 29000
GOAL_BLOCK 
GOAL_BISCUIT 27
GOAL_DOWN 0
GOAL_OBSTACLE 22
GOAL_CREAM 0
1 1 0 6 2 2 1 1
1 0 0 6 2 2 2 1
6 6 6 6 2 2 2 2
3 3 3 6 6 6 6 6
3 3 3 6 6 3 3 3
3 3 3 6 6 3 3 3
6 6 6 6 6 3 3 3
0 0 1 0 0 1 6 6
