MAP 23
MOVES 20
SCORE 29000
GOAL_BLOCK 
GOAL_BISCUIT 32
GOAL_DOWN 4
GOAL_OBSTACLE 12
GOAL_CREAM 0
5 0 1 5 5 1 0 5
0 0 1 0 0 1 0 0
2 2 2 6 6 2 2 2
2 2 2 6 6 2 2 2
3 3 3 3 3 3 3 3
1 1 3 3 3 3 1 1
6 6 3 3 3 3 6 6
6 6 3 3 3 3 6 6 