MAP 0
MOVES 22
SCORE 29000
GOAL_BLOCK 5 30
GOAL_BISCUIT 24
GOAL_DOWN 0
GOAL_OBSTACLE 28
GOAL_CREAM 4
15 36 6 6 6 6 36 15
16 15 6 6 6 6 15 16
15 36 6 6 6 6 36 15
6 6 6 6 6 6 6 6
6 6 6 6 6 6 6 6
3 3 3 3 3 3 3 3
2 2 2 2 2 2 2 2
3 3 3 3 3 3 3 3
