MAP 7
MOVES 14
SCORE 10000
GOAL_BLOCK 0 25 / 4 15
GOAL_BISCUIT 0
GOAL_DOWN 0
GOAL_OBSTACLE 0
GOAL_CREAM 0
1 1 1 1 1 1 1 1
1 0 0 0 0 11 13 1
0 0 0 0 0 0 11 11
0 0 0 0 0 0 10 12
0 0 0 0 0 0 13 10
0 0 0 0 0 0 10 13
1 0 0 0 0 0 11 1
1 1 1 1 1 1 1 1
