MAP 30
MOVES 22
SCORE 29000
GOAL_BLOCK 5 30
GOAL_BISCUIT 56
GOAL_DOWN 0
GOAL_OBSTACLE 0
GOAL_CREAM 0
2 2 2 1 1 2 2 2
2 2 2 1 1 2 2 2
1 2 2 2 2 2 2 1
2 3 3 3 3 3 3 2
2 3 3 3 3 3 3 2
2 3 3 1 1 3 3 2
2 3 3 3 3 3 3 2
2 2 2 2 2 2 2 2 