MAP 31
MOVES 22
SCORE 29000
GOAL_BLOCK 1 25 / 2 25
GOAL_BISCUIT 33
GOAL_DOWN 0
GOAL_OBSTACLE 11
GOAL_CREAM 0
0 19 1 1 1 1 1 1
6 6 0 19 1 1 1 1
2 6 6 6 0 19 1 1
2 3 2 6 6 6 0 19
2 3 2 3 2 6 6 6
2 3 2 3 2 3 2 3
2 3 2 3 2 3 2 3
2 3 2 3 2 3 2 3
