MAP 32
MOVES 20
SCORE 26000
GOAL_BLOCK 3 34 / 4 34
GOAL_BISCUIT 18
GOAL_DOWN 0
GOAL_OBSTACLE 0
GOAL_CREAM 0
0 0 0 0 0 0 1 1
0 2 2 2 0 0 1 1
0 2 2 2 0 0 0 1
0 2 2 2 0 0 0 0
0 0 0 0 3 3 3 0
1 0 0 0 3 3 3 0
1 1 0 0 3 3 3 0
1 1 0 0 0 0 0 0 