MAP 9
MOVES 25
SCORE 30000
GOAL_BLOCK 2 25 / 3 25
GOAL_BISCUIT 0
GOAL_DOWN 2
GOAL_OBSTACLE 0
GOAL_CREAM 6
1 1 5 0 0 5 1 1
1 0 0 0 0 0 0 1
0 0 0 0 0 0 0 0
0 0 0 0 0 0 0 0
0 0 0 0 0 0 0 0
0 0 0 8 8 0 0 0
0 0 8 7 7 8 0 0
0 8 7 7 7 7 8 0
