MAP 16
MOVES 22
SCORE 30000
GOAL_BLOCK 1 27 / 2 27
GOAL_BISCUIT 0
GOAL_DOWN 0
GOAL_OBSTACLE 8
GOAL_CREAM 4
1 1 1 0 0 1 1 1
1 1 0 0 0 0 1 1
1 0 0 0 0 0 0 1
0 0 6 8 8 6 0 0
1 0 6 6 6 6 0 1
0 0 6 8 8 6 0 0
1 1 1 0 0 1 1 1
1 1 0 0 0 0 1 1
