MAP 19
MOVES 22
SCORE 30000
GOAL_BLOCK 4 35 / 6 35
GOAL_BISCUIT 0
GOAL_DOWN 0
GOAL_OBSTACLE 8
GOAL_CREAM 8
0 0 0 0 0 0 0 14
15 15 11 13 16 11 12 12
1 14 15 16 13 12 14 1
6 8 34 6 6 34 8 6
6 8 34 6 6 34 8 6
1 7 7 7 7 7 7 1
7 7 7 7 7 7 7 7
7 7 7 7 7 7 7 7
