MAP 24
MOVES 26
SCORE 30000
GOAL_BLOCK 
GOAL_BISCUIT 28
GOAL_DOWN 0
GOAL_OBSTACLE 6
GOAL_CREAM 2
0 0 0 0 0 0 0 0
0 0 0 0 0 0 0 0
0 1 0 1 1 0 1 0
2 33 2 6 6 2 33 2
2 6 2 6 6 2 6 2
2 1 2 1 1 2 1 2
3 3 3 3 3 3 3 3
3 3 3 3 3 3 3 3 