MAP 20
MOVES 28
SCORE 29000
GOAL_BLOCK 3 30 / 4 30
GOAL_BISCUIT 34
GOAL_DOWN 0
GOAL_OBSTACLE 0
GOAL_CREAM 0
1 1 1 0 0 1 1 1
1 1 0 0 0 0 1 1
1 3 3 3 3 3 3 1
3 3 3 3 3 3 3 3
3 3 3 3 3 3 3 3
1 3 3 3 3 3 3 1
1 1 3 3 3 3 1 1
1 1 1 3 3 1 1 1
