MAP 13
MOVES 24
SCORE 29000
GOAL_BLOCK 
GOAL_BISCUIT 0
GOAL_DOWN 2
GOAL_OBSTACLE 34
GOAL_CREAM 0
1 0 0 5 5 0 0 1
0 0 0 6 6 0 0 0
0 0 0 6 6 0 0 0
0 6 6 6 6 6 6 0
0 6 6 6 6 6 6 0
0 6 6 6 6 6 6 0
0 6 6 6 6 6 6 0
1 6 6 6 6 6 6 1
