MAP 5
MOVES 14
SCORE 10000
GOAL_BLOCK 0 20 / 1 20 / 2 20 / 3 20
GOAL_BISCUIT 0
GOAL_DOWN 0
GOAL_OBSTACLE 0
GOAL_CREAM 0
1 0 0 1 1 0 0 1
1 0 0 1 1 0 0 1
0 0 0 0 0 0 0 0
0 0 0 0 0 0 0 0
0 0 0 0 0 0 0 0
0 0 0 0 0 0 0 0
1 1 0 0 0 0 1 1
1 1 0 0 0 0 1 1
