MAP 8
MOVES 23
SCORE 24000
GOAL_BLOCK 
GOAL_BISCUIT 0
GOAL_DOWN 0
GOAL_OBSTACLE 18
GOAL_CREAM 6
0 0 0 1 1 0 0 0
0 0 0 0 0 0 0 0
0 0 0 0 0 0 0 0
1 6 6 6 6 6 6 1
1 34 33 33 34 8 8 1
6 6 7 7 7 7 6 6
6 6 7 7 7 7 6 6
6 6 7 1 1 7 6 6
