MAP 22
MOVES 25
SCORE 28000
GOAL_BLOCK 
GOAL_BISCUIT 14
GOAL_DOWN 0
GOAL_OBSTACLE 16
GOAL_CREAM 4
0 0 0 0 0 0 0 0
0 0 0 0 0 0 0 0
0 0 0 0 0 0 0 0
0 0 8 8 8 8 0 0
6 6 6 6 6 6 6 6
6 3 3 6 6 3 3 6
3 3 3 6 6 3 3 3
3 3 1 6 6 1 3 3 