MAP 34
MOVES 19
SCORE 28000
GOAL_BLOCK 
GOAL_BISCUIT 36
GOAL_DOWN 0
GOAL_OBSTACLE 0
GOAL_CREAM 0
0 0 0 0 0 0 0 0
0 0 0 0 0 0 0 0
1 1 2 2 2 2 1 1
3 1 1 2 2 1 1 3
3 3 1 1 1 1 3 3
3 3 3 3 3 3 3 3
3 3 3 3 3 3 3 3
3 3 3 3 3 3 3 3
