MAP 0
MOVES 24
SCORE 30000
GOAL_BLOCK 5 27 / 6 27
GOAL_BISCUIT 0
GOAL_DOWN 0
GOAL_OBSTACLE 2
GOAL_CREAM 12
0 0 0 0 0 0 0 0
0 0 0 0 0 0 0 0
0 0 0 0 0 0 0 0
0 0 0 0 0 0 0 0
0 8 6 8 8 6 8 0
0 8 8 7 7 8 8 0
0 8 7 7 7 7 8 0
0 8 7 7 7 7 8 0
