MAP 35
MOVES 23
SCORE 30000
GOAL_BLOCK 
GOAL_BISCUIT 38
GOAL_DOWN 0
GOAL_OBSTACLE 0
GOAL_CREAM 0
0 0 0 0 0 0 0 0
2 2 2 2 2 2 2 2
2 2 1 1 1 1 2 2
2 1 1 3 3 1 1 2
3 3 3 21 20 3 3 3
3 1 1 3 3 1 1 3
3 3 1 1 1 1 3 3
3 3 3 3 3 3 3 3
