MAP 36
MOVES 22
SCORE 30000
GOAL_BLOCK 
GOAL_BISCUIT 30
GOAL_DOWN 0
GOAL_OBSTACLE 0
GOAL_CREAM 12
0 0 0 0 0 0 0 0
2 2 2 2 2 2 2 2
2 2 2 2 2 2 2 2
2 2 2 2 2 2 2 2
8 8 8 0 0 8 8 8
2 2 8 0 0 8 2 2
1 2 8 0 0 8 2 1
1 1 8 0 0 8 1 1
