MAP 37
MOVES 28
SCORE 32000
GOAL_BLOCK 
GOAL_BISCUIT 28
GOAL_DOWN 0
GOAL_OBSTACLE 0
GOAL_CREAM 9
0 0 0 0 0 0 0 0
0 0 0 0 0 0 0 0
0 0 0 8 8 8 8 8
8 8 8 8 1 1 1 1
2 2 2 2 1 1 1 1
2 2 2 2 3 3 3 3
2 2 2 2 3 3 3 3
2 2 2 2 3 3 3 3
