MAP 38
MOVES 25
SCORE 32000
GOAL_BLOCK 
GOAL_BISCUIT 20
GOAL_DOWN 2
GOAL_OBSTACLE 10
GOAL_CREAM 0
5 0 1 0 0 1 0 5
0 0 1 0 0 1 0 0
0 0 1 1 1 1 0 0
6 6 6 0 0 6 6 6
6 6 0 0 0 0 6 6
3 3 3 3 3 3 3 3
3 3 3 3 3 3 3 3
3 3 1 1 1 1 3 3
