MAP 39
MOVES 26
SCORE 28000
GOAL_BLOCK 3 35 / 4 35
GOAL_BISCUIT 0
GOAL_DOWN 0
GOAL_OBSTACLE 10
GOAL_CREAM 0
0 0 1 14 13 1 0 0
0 1 1 13 14 1 1 0
1 1 6 14 13 6 1 1
6 6 6 6 6 6 6 6
7 7 7 7 7 7 7 7
7 7 7 1 1 7 7 7
7 7 7 7 7 7 7 7
7 7 7 7 7 7 7 7
