MAP 5
MOVES 22
SCORE 22000
GOAL_BLOCK 5 30
GOAL_BISCUIT 0
GOAL_DOWN 0
GOAL_OBSTACLE 34
GOAL_CREAM 0
1 0 0 1 1 0 0 1
1 0 0 1 1 0 0 1
6 6 6 15 12 6 6 6
6 6 6 11 15 6 6 6
6 6 6 15 12 6 6 6
6 6 6 6 6 6 6 6
1 1 6 6 6 6 1 1
1 1 6 6 6 6 1 1
