MAP 4
MOVES 14
SCORE 10000
GOAL_BLOCK 
GOAL_BISCUIT 16
GOAL_DOWN 0
GOAL_OBSTACLE 0
GOAL_CREAM 0
1 1 10 13 11 12 1 1
1 1 12 12 10 13 1 1
0 0 2 2 2 2 0 0
0 0 2 2 2 2 0 0
0 0 2 2 2 2 0 0
0 0 2 2 2 2 0 0
1 1 0 0 0 0 1 1
1 1 0 0 0 0 1 1
