MAP 40
MOVES 21
SCORE 22000
GOAL_BLOCK 1 24 / 2 24
GOAL_BISCUIT 16
GOAL_DOWN 0
GOAL_OBSTACLE 12
GOAL_CREAM 0
1 0 0 0 0 0 2 2
2 2 0 0 0 0 2 2
2 2 0 0 0 0 1 1
6 6 6 6 6 6 1 1
1 1 6 6 6 6 6 6
1 1 0 0 0 0 3 3
3 3 0 0 0 0 3 3
3 3 0 0 0 0 0 1
