MAP 41
MOVES 21
SCORE 22000
GOAL_BLOCK 
GOAL_BISCUIT 12
GOAL_DOWN 2
GOAL_OBSTACLE 16
GOAL_CREAM 0
0 0 0 5 0 1 5 0
0 0 0 0 0 1 0 0
0 0 0 0 0 1 1 1
0 0 0 0 0 6 6 6
0 0 0 6 6 6 6 6
6 6 6 6 2 2 2 2
1 1 6 6 2 2 2 2
1 1 6 6 2 2 2 2
