MAP 42
MOVES 22
SCORE 22000
GOAL_BLOCK 
GOAL_BISCUIT 23
GOAL_DOWN 0
GOAL_OBSTACLE 11
GOAL_CREAM 0
0 0 0 0 0 0 0 0
0 0 0 0 0 1 1 0
0 0 0 0 6 6 6 2
0 1 1 1 6 3 3 2
0 1 1 1 6 3 3 2
2 6 6 6 6 3 3 2
2 3 3 3 3 1 1 2
2 3 3 3 3 6 6 2 