MAP 43
MOVES 22
SCORE 22000
GOAL_BLOCK 
GOAL_BISCUIT 32
GOAL_DOWN 0
GOAL_OBSTACLE 0
GOAL_CREAM 4
0 0 0 0 0 0 0 0
0 0 0 0 0 0 0 0
8 8 1 1 1 1 1 1
2 2 3 3 3 3 2 2
2 2 3 3 3 3 2 2
1 1 1 1 1 1 8 8
2 2 3 3 3 3 2 2
2 2 3 3 3 3 2 2 