MAP 13
MOVES 18
SCORE 22000
GOAL_BLOCK 
GOAL_BISCUIT 44
GOAL_DOWN 0
GOAL_OBSTACLE 12
GOAL_CREAM 0
1 2 2 2 2 2 20 1
19 2 3 3 6 2 2 2
2 2 3 3 6 3 3 2
2 6 6 6 6 3 3 2
2 3 3 6 6 6 6 2
2 3 3 6 3 3 2 2
2 2 2 6 3 3 2 19
1 20 2 2 2 2 2 1
