MAP 25
MOVES 21
SCORE 22000
GOAL_BLOCK 2 35 / 3 35 / 4 35
GOAL_BISCUIT 0
GOAL_DOWN 2
GOAL_OBSTACLE 0
GOAL_CREAM 0
1 1 1 0 0 1 1 1
0 1 5 0 0 5 1 0
0 0 0 0 0 0 0 0
0 0 0 0 0 0 0 0
0 0 0 0 0 0 0 0
0 0 0 0 0 0 0 0
0 0 0 0 0 0 0 0
1 0 0 0 0 0 0 1
