MAP 30
MOVES 20
SCORE 22000
GOAL_BLOCK 
GOAL_BISCUIT 0
GOAL_DOWN 2
GOAL_OBSTACLE 18
GOAL_CREAM 4
0 5 0 1 1 0 5 0
0 0 0 1 1 0 0 0
1 6 6 12 14 6 6 1
6 6 6 14 12 6 6 6
7 7 6 12 14 6 7 7
7 7 6 1 1 6 7 7
7 7 6 6 6 6 7 7
7 7 8 8 8 8 7 7
