MAP 4
MOVES 19
SCORE 22000
GOAL_BLOCK 6 30
GOAL_BISCUIT 36
GOAL_DOWN 0
GOAL_OBSTACLE 0
GOAL_CREAM 4
1 1 0 0 0 0 1 1
1 1 0 0 0 0 1 1
2 2 2 2 2 2 2 2
3 3 2 8 8 2 3 3
3 3 2 8 8 2 3 3
2 2 2 2 2 2 2 2
1 1 2 3 3 2 1 1
1 1 2 3 3 2 1 1 