MAP 44
MOVES 20
SCORE 22000
GOAL_BLOCK 6 30
GOAL_BISCUIT 0
GOAL_DOWN 4
GOAL_OBSTACLE 16
GOAL_CREAM 0
5 0 0 5 5 0 0 5
0 0 0 0 0 0 0 0
0 0 0 0 0 0 0 0
0 0 0 0 0 0 0 0
6 6 6 6 6 6 6 6
6 6 6 6 6 6 6 6
7 7 1 1 1 1 7 7
7 7 1 7 7 1 7 7 