MAP 45
MOVES 21
SCORE 22000
GOAL_BLOCK 5 30 / 6 30
GOAL_BISCUIT 24
GOAL_DOWN 0
GOAL_OBSTACLE 0
GOAL_CREAM 0
0 0 0 0 0 0 0 0
0 0 0 0 0 0 0 0
1 1 1 3 3 1 1 1
0 0 1 3 3 1 0 0
0 0 1 2 2 1 0 0
1 1 1 2 2 1 1 1
2 2 2 3 3 2 2 2
2 2 2 3 3 2 2 2 